instant,dteday,season_day,yr_day,mnth_day,holiday_day,weekday_day,workingday_day,weathersit_day,temp_day,atemp_day,hum_day,windspeed_day,casual_day,registered_day,cnt_day,season_hour,yr_hour,mnth_hour,holiday_hour,weekday_hour,workingday_hour,weathersit_hour,temp_hour,atemp_hour,hum_hour,windspeed_hour,casual_hour,registered_hour,cnt_hour,day_type
1,2011-01-01,1,0,1,0,6,0,2,0.344167,0.363625,0.805833,0.160446,331,654,985,1,0,1,0,6,0,1,0.3441666666666667,0.36362500000000003,0.8058333333333333,0.16044583333333332,331,654,985,Weekend
2,2011-01-02,1,0,1,0,0,0,2,0.363478,0.353739,0.696087,0.248539,131,670,801,1,0,1,0,0,0,2,0.3634782608695652,0.35373913043478256,0.696086956521739,0.24853913043478262,131,670,801,Weekend
3,2011-01-03,1,0,1,0,1,1,1,0.196364,0.189405,0.437273,0.248309,120,1229,1349,1,0,1,0,1,1,1,0.19636363636363638,0.18940454545454546,0.43727272727272726,0.2483090909090909,120,1229,1349,Working Day
4,2011-01-04,1,0,1,0,2,1,1,0.2,0.212122,0.590435,0.160296,108,1454,1562,1,0,1,0,2,1,1,0.19999999999999998,0.21212173913043478,0.5904347826086956,0.16029565217391303,108,1454,1562,Working Day
5,2011-01-05,1,0,1,0,3,1,1,0.226957,0.22927,0.436957,0.1869,82,1518,1600,1,0,1,0,3,1,1,0.22695652173913042,0.2292695652173913,0.43695652173913047,0.1869,82,1518,1600,Working Day
6,2011-01-06,1,0,1,0,4,1,1,0.204348,0.233209,0.518261,0.0895652,88,1518,1606,1,0,1,0,4,1,1,0.20434782608695654,0.23320869565217392,0.5182608695652174,0.08956521739130435,88,1518,1606,Working Day
7,2011-01-07,1,0,1,0,5,1,2,0.196522,0.208839,0.498696,0.168726,148,1362,1510,1,0,1,0,5,1,2,0.1965217391304348,0.2088391304347826,0.498695652173913,0.16872608695652175,148,1362,1510,Working Day
8,2011-01-08,1,0,1,0,6,0,2,0.165,0.162254,0.535833,0.266804,68,891,959,1,0,1,0,6,0,2,0.165,0.16225416666666667,0.5358333333333333,0.2668041666666667,68,891,959,Weekend
9,2011-01-09,1,0,1,0,0,0,1,0.138333,0.116175,0.434167,0.36195,54,768,822,1,0,1,0,0,0,1,0.13833333333333334,0.11617499999999999,0.43416666666666665,0.36195,54,768,822,Weekend
10,2011-01-10,1,0,1,0,1,1,1,0.150833,0.150888,0.482917,0.223267,41,1280,1321,1,0,1,0,1,1,1,0.15083333333333335,0.1508875,0.48291666666666666,0.2232666666666667,41,1280,1321,Working Day
11,2011-01-11,1,0,1,0,2,1,2,0.169091,0.191464,0.686364,0.122132,43,1220,1263,1,0,1,0,2,1,1,0.1690909090909091,0.19146363636363636,0.6863636363636364,0.12213181818181819,43,1220,1263,Working Day
12,2011-01-12,1,0,1,0,3,1,1,0.172727,0.160473,0.599545,0.304627,25,1137,1162,1,0,1,0,3,1,2,0.17272727272727273,0.16047272727272727,0.5995454545454545,0.30462727272727275,25,1137,1162,Working Day
13,2011-01-13,1,0,1,0,4,1,1,0.165,0.150883,0.470417,0.301,38,1368,1406,1,0,1,0,4,1,1,0.165,0.15088333333333334,0.47041666666666665,0.301,38,1368,1406,Working Day
14,2011-01-14,1,0,1,0,5,1,1,0.16087,0.188413,0.537826,0.126548,54,1367,1421,1,0,1,0,5,1,1,0.16086956521739132,0.18841304347826088,0.5378260869565217,0.12654782608695653,54,1367,1421,Working Day
15,2011-01-15,1,0,1,0,6,0,2,0.233333,0.248112,0.49875,0.157963,222,1026,1248,1,0,1,0,6,0,1,0.2333333333333333,0.24811249999999999,0.49875,0.1579625,222,1026,1248,Weekend
16,2011-01-16,1,0,1,0,0,0,1,0.231667,0.234217,0.48375,0.188433,251,953,1204,1,0,1,0,0,0,1,0.2316666666666667,0.23421666666666666,0.48374999999999996,0.18843333333333334,251,953,1204,Weekend
17,2011-01-17,1,0,1,1,1,0,2,0.175833,0.176771,0.5375,0.194017,117,883,1000,1,0,1,1,1,0,2,0.1758333333333333,0.17677083333333332,0.5375,0.19401666666666664,117,883,1000,Holiday
18,2011-01-18,1,0,1,0,2,1,2,0.216667,0.232333,0.861667,0.146775,9,674,683,1,0,1,0,2,1,2,0.21666666666666667,0.2323333333333333,0.8616666666666667,0.14677500000000002,9,674,683,Working Day
19,2011-01-19,1,0,1,0,3,1,2,0.292174,0.298422,0.741739,0.208317,78,1572,1650,1,0,1,0,3,1,2,0.29217391304347823,0.2984217391304348,0.7417391304347826,0.20831739130434782,78,1572,1650,Working Day
20,2011-01-20,1,0,1,0,4,1,2,0.261667,0.25505,0.538333,0.195904,83,1844,1927,1,0,1,0,4,1,1,0.26166666666666666,0.25505,0.5383333333333333,0.19590416666666666,83,1844,1927,Working Day
21,2011-01-21,1,0,1,0,5,1,1,0.1775,0.157833,0.457083,0.353242,75,1468,1543,1,0,1,0,5,1,2,0.1775,0.15783333333333333,0.45708333333333334,0.3532416666666667,75,1468,1543,Working Day
22,2011-01-22,1,0,1,0,6,0,1,0.0591304,0.0790696,0.4,0.17197,93,888,981,1,0,1,0,6,0,1,0.0591304347826087,0.07906956521739131,0.39999999999999997,0.1719695652173913,93,888,981,Weekend
23,2011-01-23,1,0,1,0,0,0,1,0.0965217,0.0988391,0.436522,0.2466,150,836,986,1,0,1,0,0,0,1,0.0965217391304348,0.09883913043478261,0.43652173913043474,0.2466,150,836,986,Weekend
24,2011-01-24,1,0,1,0,1,1,1,0.0973913,0.11793,0.491739,0.15833,86,1330,1416,1,0,1,0,1,1,1,0.0973913043478261,0.11793043478260869,0.4917391304347826,0.1583304347826087,86,1330,1416,Working Day
25,2011-01-25,1,0,1,0,2,1,2,0.223478,0.234526,0.616957,0.129796,186,1799,1985,1,0,1,0,2,1,2,0.2234782608695652,0.23452608695652175,0.6169565217391304,0.12979565217391303,186,1799,1985,Working Day
26,2011-01-26,1,0,1,0,3,1,3,0.2175,0.2036,0.8625,0.29385,34,472,506,1,0,1,0,3,1,2,0.2175,0.2036,0.8625,0.29385,34,472,506,Working Day
27,2011-01-27,1,0,1,0,4,1,1,0.195,0.2197,0.6875,0.113837,15,416,431,1,0,1,0,4,1,1,0.195,0.2197,0.6875,0.11383750000000001,15,416,431,Working Day
28,2011-01-28,1,0,1,0,5,1,2,0.203478,0.223317,0.793043,0.1233,38,1129,1167,1,0,1,0,5,1,2,0.2034782608695652,0.22331739130434783,0.7930434782608696,0.1233,38,1129,1167,Working Day
29,2011-01-29,1,0,1,0,6,0,1,0.196522,0.212126,0.651739,0.145365,123,975,1098,1,0,1,0,6,0,1,0.19652173913043477,0.21212608695652174,0.6517391304347826,0.14536521739130434,123,975,1098,Weekend
30,2011-01-30,1,0,1,0,0,0,1,0.216522,0.250322,0.722174,0.0739826,140,956,1096,1,0,1,0,0,0,1,0.2165217391304348,0.25032173913043476,0.7221739130434782,0.07398260869565218,140,956,1096,Weekend
31,2011-01-31,1,0,1,0,1,1,2,0.180833,0.18625,0.60375,0.187192,42,1459,1501,1,0,1,0,1,1,2,0.18083333333333332,0.18625,0.60375,0.18719166666666667,42,1459,1501,Working Day
32,2011-02-01,1,0,2,0,2,1,2,0.192174,0.23453,0.829565,0.053213,47,1313,1360,1,0,2,0,2,1,2,0.19217391304347825,0.23453043478260868,0.8295652173913044,0.05321304347826087,47,1313,1360,Working Day
33,2011-02-02,1,0,2,0,3,1,2,0.26,0.254417,0.775417,0.264308,72,1454,1526,1,0,2,0,3,1,3,0.26,0.2544166666666667,0.7754166666666666,0.2643083333333333,72,1454,1526,Working Day
34,2011-02-03,1,0,2,0,4,1,1,0.186957,0.177878,0.437826,0.277752,61,1489,1550,1,0,2,0,4,1,1,0.18695652173913044,0.1778782608695652,0.43782608695652175,0.27775217391304347,61,1489,1550,Working Day
35,2011-02-04,1,0,2,0,5,1,2,0.211304,0.228587,0.585217,0.127839,88,1620,1708,1,0,2,0,5,1,2,0.21130434782608698,0.22858695652173913,0.5852173913043479,0.12783913043478262,88,1620,1708,Working Day
36,2011-02-05,1,0,2,0,6,0,2,0.233333,0.243058,0.929167,0.161079,100,905,1005,1,0,2,0,6,0,2,0.2333333333333333,0.24305833333333335,0.9291666666666667,0.16107916666666666,100,905,1005,Weekend
37,2011-02-06,1,0,2,0,0,0,1,0.285833,0.291671,0.568333,0.1418,354,1269,1623,1,0,2,0,0,0,1,0.28583333333333333,0.2916708333333333,0.5683333333333334,0.1418,354,1269,1623,Weekend
38,2011-02-07,1,0,2,0,1,1,1,0.271667,0.303658,0.738333,0.0454083,120,1592,1712,1,0,2,0,1,1,1,0.27166666666666667,0.3036583333333333,0.7383333333333333,0.045408333333333335,120,1592,1712,Working Day
39,2011-02-08,1,0,2,0,2,1,1,0.220833,0.198246,0.537917,0.36195,64,1466,1530,1,0,2,0,2,1,2,0.22083333333333333,0.19824583333333334,0.5379166666666667,0.36195,64,1466,1530,Working Day
40,2011-02-09,1,0,2,0,3,1,2,0.134783,0.144283,0.494783,0.188839,53,1552,1605,1,0,2,0,3,1,1,0.13478260869565217,0.14428260869565215,0.4947826086956522,0.18883913043478262,53,1552,1605,Working Day
41,2011-02-10,1,0,2,0,4,1,1,0.144348,0.149548,0.437391,0.221935,47,1491,1538,1,0,2,0,4,1,3,0.14434782608695654,0.14954782608695652,0.4373913043478261,0.22193478260869565,47,1491,1538,Working Day
42,2011-02-11,1,0,2,0,5,1,1,0.189091,0.213509,0.506364,0.10855,149,1597,1746,1,0,2,0,5,1,1,0.1890909090909091,0.2135090909090909,0.5063636363636363,0.10855000000000001,149,1597,1746,Working Day
43,2011-02-12,1,0,2,0,6,0,1,0.2225,0.232954,0.544167,0.203367,288,1184,1472,1,0,2,0,6,0,1,0.2225,0.23295416666666666,0.5441666666666667,0.20336666666666667,288,1184,1472,Weekend
44,2011-02-13,1,0,2,0,0,0,1,0.316522,0.324113,0.457391,0.260883,397,1192,1589,1,0,2,0,0,0,1,0.3165217391304348,0.32411304347826086,0.45739130434782604,0.26088260869565216,397,1192,1589,Weekend
45,2011-02-14,1,0,2,0,1,1,1,0.415,0.39835,0.375833,0.417908,208,1705,1913,1,0,2,0,1,1,1,0.41500000000000004,0.39835,0.3758333333333333,0.4179083333333333,208,1705,1913,Working Day
46,2011-02-15,1,0,2,0,2,1,1,0.266087,0.254274,0.314348,0.291374,140,1675,1815,1,0,2,0,2,1,1,0.26608695652173914,0.25427391304347824,0.31434782608695655,0.29137391304347826,140,1675,1815,Working Day
47,2011-02-16,1,0,2,0,3,1,1,0.318261,0.3162,0.423478,0.251791,218,1897,2115,1,0,2,0,3,1,1,0.31826086956521743,0.3162,0.42347826086956525,0.2517913043478261,218,1897,2115,Working Day
48,2011-02-17,1,0,2,0,4,1,1,0.435833,0.428658,0.505,0.230104,259,2216,2475,1,0,2,0,4,1,1,0.43583333333333335,0.4286583333333333,0.505,0.23010416666666667,259,2216,2475,Working Day
49,2011-02-18,1,0,2,0,5,1,1,0.521667,0.511983,0.516667,0.264925,579,2348,2927,1,0,2,0,5,1,1,0.5216666666666666,0.5119833333333333,0.5166666666666667,0.264925,579,2348,2927,Working Day
50,2011-02-19,1,0,2,0,6,0,1,0.399167,0.391404,0.187917,0.507463,532,1103,1635,1,0,2,0,6,0,1,0.39916666666666667,0.3914041666666667,0.18791666666666665,0.5074625,532,1103,1635,Weekend
51,2011-02-20,1,0,2,0,0,0,1,0.285217,0.27733,0.407826,0.223235,639,1173,1812,1,0,2,0,0,0,1,0.28521739130434787,0.27733043478260866,0.40782608695652167,0.22323478260869567,639,1173,1812,Weekend
52,2011-02-21,1,0,2,1,1,0,2,0.303333,0.284075,0.605,0.307846,195,912,1107,1,0,2,1,1,0,2,0.30333333333333334,0.284075,0.605,0.3078458333333333,195,912,1107,Holiday
53,2011-02-22,1,0,2,0,2,1,1,0.182222,0.186033,0.577778,0.195683,74,1376,1450,1,0,2,0,2,1,2,0.18222222222222223,0.18603333333333336,0.5777777777777778,0.19568333333333332,74,1376,1450,Working Day
54,2011-02-23,1,0,2,0,3,1,1,0.221739,0.245717,0.423043,0.094113,139,1778,1917,1,0,2,0,3,1,1,0.2217391304347826,0.2457173913043478,0.4230434782608696,0.09411304347826087,139,1778,1917,Working Day
55,2011-02-24,1,0,2,0,4,1,2,0.295652,0.289191,0.697391,0.250496,100,1707,1807,1,0,2,0,4,1,1,0.2956521739130435,0.2891913043478261,0.697391304347826,0.25049565217391306,100,1707,1807,Working Day
56,2011-02-25,1,0,2,0,5,1,2,0.364348,0.350461,0.712174,0.346539,120,1341,1461,1,0,2,0,5,1,3,0.36434782608695654,0.3504608695652173,0.7121739130434782,0.34653913043478257,120,1341,1461,Working Day
57,2011-02-26,1,0,2,0,6,0,1,0.2825,0.282192,0.537917,0.186571,424,1545,1969,1,0,2,0,6,0,1,0.28250000000000003,0.2821916666666667,0.5379166666666667,0.18657083333333335,424,1545,1969,Weekend
58,2011-02-27,1,0,2,0,0,0,1,0.343478,0.351109,0.68,0.125248,694,1708,2402,1,0,2,0,0,0,1,0.34347826086956523,0.3511086956521739,0.68,0.12524782608695653,694,1708,2402,Weekend
59,2011-02-28,1,0,2,0,1,1,2,0.407273,0.400118,0.876364,0.289686,81,1365,1446,1,0,2,0,1,1,2,0.4072727272727273,0.4001181818181818,0.8763636363636365,0.28968636363636363,81,1365,1446,Working Day
60,2011-03-01,1,0,3,0,2,1,1,0.266667,0.263879,0.535,0.216425,137,1714,1851,1,0,3,0,2,1,1,0.26666666666666666,0.26387916666666666,0.535,0.216425,137,1714,1851,Working Day
61,2011-03-02,1,0,3,0,3,1,1,0.335,0.320071,0.449583,0.307833,231,1903,2134,1,0,3,0,3,1,1,0.335,0.32007083333333336,0.4495833333333333,0.30783333333333335,231,1903,2134,Working Day
62,2011-03-03,1,0,3,0,4,1,1,0.198333,0.200133,0.318333,0.225754,123,1562,1685,1,0,3,0,4,1,1,0.19833333333333333,0.20013333333333336,0.3183333333333333,0.22575416666666667,123,1562,1685,Working Day
63,2011-03-04,1,0,3,0,5,1,2,0.261667,0.255679,0.610417,0.203346,214,1730,1944,1,0,3,0,5,1,2,0.26166666666666666,0.2556791666666666,0.6104166666666667,0.20334583333333334,214,1730,1944,Working Day
64,2011-03-05,1,0,3,0,6,0,2,0.384167,0.378779,0.789167,0.251871,640,1437,2077,1,0,3,0,6,0,2,0.3841666666666667,0.37877916666666667,0.7891666666666667,0.2518708333333333,640,1437,2077,Weekend
65,2011-03-06,1,0,3,0,0,0,2,0.376522,0.366252,0.948261,0.343287,114,491,605,1,0,3,0,0,0,2,0.3765217391304348,0.3662521739130435,0.9482608695652174,0.34328695652173913,114,491,605,Weekend
66,2011-03-07,1,0,3,0,1,1,1,0.261739,0.238461,0.551304,0.341352,244,1628,1872,1,0,3,0,1,1,3,0.26173913043478264,0.23846086956521736,0.551304347826087,0.34135217391304346,244,1628,1872,Working Day
67,2011-03-08,1,0,3,0,2,1,1,0.2925,0.3024,0.420833,0.12065,316,1817,2133,1,0,3,0,2,1,1,0.2925,0.3024,0.42083333333333334,0.12065,316,1817,2133,Working Day
68,2011-03-09,1,0,3,0,3,1,2,0.295833,0.286608,0.775417,0.22015,191,1700,1891,1,0,3,0,3,1,1,0.29583333333333334,0.2866083333333333,0.7754166666666666,0.22014999999999998,191,1700,1891,Working Day
69,2011-03-10,1,0,3,0,4,1,3,0.389091,0.385668,0.0,0.261877,46,577,623,1,0,3,0,4,1,3,0.3890909090909091,0.3856681818181818,0.0,0.26187727272727274,46,577,623,Working Day
70,2011-03-11,1,0,3,0,5,1,2,0.316522,0.305,0.649565,0.23297,247,1730,1977,1,0,3,0,5,1,2,0.3165217391304348,0.305,0.6495652173913044,0.2329695652173913,247,1730,1977,Working Day
71,2011-03-12,1,0,3,0,6,0,1,0.329167,0.32575,0.594583,0.220775,724,1408,2132,1,0,3,0,6,0,1,0.32916666666666666,0.32575,0.5945833333333334,0.22077500000000003,724,1408,2132,Weekend
72,2011-03-13,1,0,3,0,0,0,1,0.384348,0.380091,0.527391,0.270604,982,1435,2417,1,0,3,0,0,0,1,0.3843478260869565,0.3800913043478261,0.5273913043478261,0.270604347826087,982,1435,2417,Weekend
73,2011-03-14,1,0,3,0,1,1,1,0.325217,0.332,0.496957,0.136926,359,1687,2046,1,0,3,0,1,1,1,0.32521739130434785,0.33199999999999996,0.4969565217391304,0.13692608695652173,359,1687,2046,Working Day
74,2011-03-15,1,0,3,0,2,1,2,0.317391,0.318178,0.655652,0.184309,289,1767,2056,1,0,3,0,2,1,1,0.3173913043478261,0.3181782608695652,0.6556521739130435,0.18430869565217395,289,1767,2056,Working Day
75,2011-03-16,1,0,3,0,3,1,2,0.365217,0.36693,0.776522,0.203117,321,1871,2192,1,0,3,0,3,1,3,0.3652173913043478,0.3669304347826087,0.7765217391304348,0.2031173913043478,321,1871,2192,Working Day
76,2011-03-17,1,0,3,0,4,1,1,0.415,0.410333,0.602917,0.209579,424,2320,2744,1,0,3,0,4,1,1,0.41500000000000004,0.4103333333333334,0.6029166666666667,0.20957916666666665,424,2320,2744,Working Day
77,2011-03-18,1,0,3,0,5,1,1,0.54,0.527009,0.525217,0.231017,884,2355,3239,1,0,3,0,5,1,1,0.54,0.5270086956521739,0.5252173913043479,0.2310173913043478,884,2355,3239,Working Day
78,2011-03-19,1,0,3,0,6,0,1,0.4725,0.466525,0.379167,0.368167,1424,1693,3117,1,0,3,0,6,0,2,0.4725,0.466525,0.37916666666666665,0.3681666666666667,1424,1693,3117,Weekend
79,2011-03-20,1,0,3,0,0,0,1,0.3325,0.32575,0.47375,0.207721,1047,1424,2471,1,0,3,0,0,0,1,0.3325,0.32575,0.47375000000000006,0.20772083333333335,1047,1424,2471,Weekend
80,2011-03-21,2,0,3,0,1,1,2,0.430435,0.409735,0.737391,0.288783,401,1676,2077,2,0,3,0,1,1,3,0.43043478260869567,0.4097347826086956,0.7373913043478261,0.2887826086956522,401,1676,2077,Working Day
81,2011-03-22,2,0,3,0,2,1,1,0.441667,0.440642,0.624583,0.22575,460,2243,2703,2,0,3,0,2,1,1,0.44166666666666665,0.44064166666666665,0.6245833333333334,0.22575,460,2243,2703,Working Day
82,2011-03-23,2,0,3,0,3,1,2,0.346957,0.337939,0.839565,0.234261,203,1918,2121,2,0,3,0,3,1,3,0.34695652173913044,0.3379391304347826,0.8395652173913043,0.23426086956521738,203,1918,2121,Working Day
83,2011-03-24,2,0,3,0,4,1,2,0.285,0.270833,0.805833,0.243787,166,1699,1865,2,0,3,0,4,1,2,0.285,0.2708333333333333,0.8058333333333333,0.24378750000000002,166,1699,1865,Working Day
84,2011-03-25,2,0,3,0,5,1,1,0.264167,0.256312,0.495,0.230725,300,1910,2210,2,0,3,0,5,1,1,0.26416666666666666,0.2563125,0.49499999999999994,0.23072499999999999,300,1910,2210,Working Day
85,2011-03-26,2,0,3,0,6,0,1,0.265833,0.257571,0.394167,0.209571,981,1515,2496,2,0,3,0,6,0,2,0.2658333333333333,0.25757083333333336,0.3941666666666667,0.20957083333333335,981,1515,2496,Weekend
86,2011-03-27,2,0,3,0,0,0,2,0.253043,0.250339,0.493913,0.1843,472,1221,1693,2,0,3,0,0,0,2,0.2530434782608696,0.25033913043478256,0.49391304347826087,0.1843,472,1221,1693,Weekend
87,2011-03-28,2,0,3,0,1,1,1,0.264348,0.257574,0.302174,0.212204,222,1806,2028,2,0,3,0,1,1,1,0.2643478260869565,0.25757391304347826,0.3021739130434783,0.21220434782608696,222,1806,2028,Working Day
88,2011-03-29,2,0,3,0,2,1,1,0.3025,0.292908,0.314167,0.226996,317,2108,2425,2,0,3,0,2,1,1,0.3025,0.2929083333333333,0.31416666666666665,0.2269958333333333,317,2108,2425,Working Day
89,2011-03-30,2,0,3,0,3,1,2,0.3,0.29735,0.646667,0.172888,168,1368,1536,2,0,3,0,3,1,2,0.3,0.29735,0.6466666666666666,0.1728875,168,1368,1536,Working Day
90,2011-03-31,2,0,3,0,4,1,3,0.268333,0.257575,0.918333,0.217646,179,1506,1685,2,0,3,0,4,1,3,0.26833333333333337,0.257575,0.9183333333333333,0.21764583333333332,179,1506,1685,Working Day
91,2011-04-01,2,0,4,0,5,1,2,0.3,0.283454,0.68625,0.258708,307,1920,2227,2,0,4,0,5,1,3,0.3,0.2834541666666667,0.6862499999999999,0.2587083333333334,307,1920,2227,Working Day
92,2011-04-02,2,0,4,0,6,0,2,0.315,0.315637,0.65375,0.197146,898,1354,2252,2,0,4,0,6,0,2,0.315,0.31563749999999996,0.6537499999999999,0.19714583333333335,898,1354,2252,Weekend
93,2011-04-03,2,0,4,0,0,0,1,0.378333,0.378767,0.48,0.182213,1651,1598,3249,2,0,4,0,0,0,1,0.37833333333333335,0.3787666666666667,0.48,0.1822125,1651,1598,3249,Weekend
94,2011-04-04,2,0,4,0,1,1,1,0.573333,0.542929,0.42625,0.385571,734,2381,3115,2,0,4,0,1,1,1,0.5733333333333334,0.5429291666666667,0.42625,0.38557083333333336,734,2381,3115,Working Day
95,2011-04-05,2,0,4,0,2,1,2,0.414167,0.39835,0.642083,0.388067,167,1628,1795,2,0,4,0,2,1,1,0.4141666666666666,0.39835,0.6420833333333333,0.3880666666666666,167,1628,1795,Working Day
96,2011-04-06,2,0,4,0,3,1,1,0.390833,0.387608,0.470833,0.263063,413,2395,2808,2,0,4,0,3,1,1,0.39083333333333337,0.38760833333333333,0.47083333333333327,0.26306250000000003,413,2395,2808,Working Day
97,2011-04-07,2,0,4,0,4,1,1,0.4375,0.433696,0.602917,0.162312,571,2570,3141,2,0,4,0,4,1,1,0.4375,0.43369583333333334,0.6029166666666667,0.1623125,571,2570,3141,Working Day
98,2011-04-08,2,0,4,0,5,1,2,0.335833,0.324479,0.83625,0.226992,172,1299,1471,2,0,4,0,5,1,2,0.3358333333333334,0.32447916666666665,0.83625,0.22699166666666667,172,1299,1471,Working Day
99,2011-04-09,2,0,4,0,6,0,2,0.3425,0.341529,0.8775,0.133083,879,1576,2455,2,0,4,0,6,0,2,0.3425,0.34152916666666666,0.8775,0.13308333333333333,879,1576,2455,Weekend
100,2011-04-10,2,0,4,0,0,0,2,0.426667,0.426737,0.8575,0.146767,1188,1707,2895,2,0,4,0,0,0,2,0.4266666666666667,0.4267375,0.8574999999999999,0.14676666666666668,1188,1707,2895,Weekend
101,2011-04-11,2,0,4,0,1,1,2,0.595652,0.565217,0.716956,0.324474,855,2493,3348,2,0,4,0,1,1,1,0.5956521739130435,0.5652173913043478,0.7169565217391304,0.3244739130434783,855,2493,3348,Working Day
102,2011-04-12,2,0,4,0,2,1,2,0.5025,0.493054,0.739167,0.274879,257,1777,2034,2,0,4,0,2,1,2,0.5025000000000001,0.4930541666666666,0.7391666666666666,0.2748791666666667,257,1777,2034,Working Day
103,2011-04-13,2,0,4,0,3,1,2,0.4125,0.417283,0.819167,0.250617,209,1953,2162,2,0,4,0,3,1,2,0.41250000000000003,0.4172833333333334,0.8191666666666667,0.25061666666666665,209,1953,2162,Working Day
104,2011-04-14,2,0,4,0,4,1,1,0.4675,0.462742,0.540417,0.1107,529,2738,3267,2,0,4,0,4,1,1,0.4675,0.46274166666666666,0.5404166666666667,0.1107,529,2738,3267,Working Day
105,2011-04-15,2,0,4,1,5,0,1,0.446667,0.441913,0.67125,0.226375,642,2484,3126,2,0,4,1,5,0,1,0.4466666666666667,0.4419125,0.67125,0.226375,642,2484,3126,Holiday
106,2011-04-16,2,0,4,0,6,0,3,0.430833,0.425492,0.888333,0.340808,121,674,795,2,0,4,0,6,0,2,0.43083333333333335,0.42549166666666666,0.8883333333333333,0.3408083333333333,121,674,795,Weekend
107,2011-04-17,2,0,4,0,0,0,1,0.456667,0.445696,0.479583,0.303496,1558,2186,3744,2,0,4,0,0,0,2,0.4566666666666667,0.44569583333333335,0.4795833333333333,0.30349583333333335,1558,2186,3744,Weekend
108,2011-04-18,2,0,4,0,1,1,1,0.5125,0.503146,0.5425,0.163567,669,2760,3429,2,0,4,0,1,1,1,0.5125000000000001,0.5031458333333333,0.5425,0.16356666666666667,669,2760,3429,Working Day
109,2011-04-19,2,0,4,0,2,1,2,0.505833,0.489258,0.665833,0.157971,409,2795,3204,2,0,4,0,2,1,1,0.5058333333333334,0.48925833333333335,0.6658333333333334,0.15797083333333334,409,2795,3204,Working Day
110,2011-04-20,2,0,4,0,3,1,1,0.595,0.564392,0.614167,0.241925,613,3331,3944,2,0,4,0,3,1,1,0.595,0.5643916666666666,0.6141666666666666,0.24192500000000003,613,3331,3944,Working Day
111,2011-04-21,2,0,4,0,4,1,1,0.459167,0.453892,0.407083,0.325258,745,3444,4189,2,0,4,0,4,1,1,0.45916666666666667,0.45389166666666664,0.4070833333333333,0.32525833333333337,745,3444,4189,Working Day
112,2011-04-22,2,0,4,0,5,1,2,0.336667,0.321954,0.729583,0.219521,177,1506,1683,2,0,4,0,5,1,1,0.33666666666666667,0.32195416666666665,0.7295833333333334,0.2195208333333333,177,1506,1683,Working Day
113,2011-04-23,2,0,4,0,6,0,2,0.46,0.450121,0.887917,0.230725,1462,2574,4036,2,0,4,0,6,0,2,0.46,0.4501208333333333,0.8879166666666666,0.23072499999999999,1462,2574,4036,Weekend
114,2011-04-24,2,0,4,0,0,0,2,0.581667,0.551763,0.810833,0.192175,1710,2481,4191,2,0,4,0,0,0,1,0.5816666666666667,0.5517625,0.8108333333333334,0.19217499999999998,1710,2481,4191,Weekend
115,2011-04-25,2,0,4,0,1,1,1,0.606667,0.5745,0.776667,0.185333,773,3300,4073,2,0,4,0,1,1,3,0.6066666666666667,0.5745,0.7766666666666667,0.18533333333333335,773,3300,4073,Working Day
116,2011-04-26,2,0,4,0,2,1,1,0.631667,0.594083,0.729167,0.3265,678,3722,4400,2,0,4,0,2,1,1,0.6316666666666667,0.5940833333333333,0.7291666666666666,0.3265,678,3722,4400,Working Day
117,2011-04-27,2,0,4,0,3,1,2,0.62,0.575142,0.835417,0.3122,547,3325,3872,2,0,4,0,3,1,1,0.62,0.5751416666666667,0.8354166666666667,0.3122,547,3325,3872,Working Day
118,2011-04-28,2,0,4,0,4,1,2,0.6175,0.578929,0.700833,0.320908,569,3489,4058,2,0,4,0,4,1,1,0.6175,0.5789291666666666,0.7008333333333333,0.32090833333333335,569,3489,4058,Working Day
119,2011-04-29,2,0,4,0,5,1,1,0.51,0.497463,0.457083,0.240063,878,3717,4595,2,0,4,0,5,1,1,0.51,0.4974625,0.45708333333333334,0.24006249999999998,878,3717,4595,Working Day
120,2011-04-30,2,0,4,0,6,0,1,0.4725,0.464021,0.503333,0.235075,1965,3347,5312,2,0,4,0,6,0,2,0.4725,0.4640208333333333,0.5033333333333333,0.235075,1965,3347,5312,Weekend
121,2011-05-01,2,0,5,0,0,0,2,0.451667,0.448204,0.762083,0.106354,1138,2213,3351,2,0,5,0,0,0,1,0.45166666666666666,0.4482041666666667,0.7620833333333333,0.10635416666666668,1138,2213,3351,Weekend
122,2011-05-02,2,0,5,0,1,1,2,0.549167,0.532833,0.73,0.183454,847,3554,4401,2,0,5,0,1,1,1,0.5491666666666667,0.5328333333333334,0.73,0.18345416666666667,847,3554,4401,Working Day
123,2011-05-03,2,0,5,0,2,1,2,0.616667,0.582079,0.697083,0.342667,603,3848,4451,2,0,5,0,2,1,2,0.6166666666666667,0.5820791666666666,0.6970833333333334,0.3426666666666667,603,3848,4451,Working Day
124,2011-05-04,2,0,5,0,3,1,2,0.414167,0.40465,0.737083,0.328996,255,2378,2633,2,0,5,0,3,1,3,0.4141666666666666,0.40465,0.7370833333333334,0.3289958333333333,255,2378,2633,Working Day
125,2011-05-05,2,0,5,0,4,1,1,0.459167,0.441917,0.444167,0.295392,614,3819,4433,2,0,5,0,4,1,1,0.45916666666666667,0.4419166666666667,0.44416666666666665,0.29539166666666666,614,3819,4433,Working Day
126,2011-05-06,2,0,5,0,5,1,1,0.479167,0.474117,0.59,0.228246,894,3714,4608,2,0,5,0,5,1,1,0.4791666666666667,0.4741166666666667,0.59,0.22824583333333334,894,3714,4608,Working Day
127,2011-05-07,2,0,5,0,6,0,1,0.52,0.512621,0.54125,0.16045,1612,3102,4714,2,0,5,0,6,0,1,0.52,0.5126208333333333,0.54125,0.16045,1612,3102,4714,Weekend
128,2011-05-08,2,0,5,0,0,0,1,0.528333,0.518933,0.631667,0.0746375,1401,2932,4333,2,0,5,0,0,0,2,0.5283333333333333,0.5189333333333334,0.6316666666666667,0.0746375,1401,2932,4333,Weekend
129,2011-05-09,2,0,5,0,1,1,1,0.5325,0.525246,0.58875,0.176,664,3698,4362,2,0,5,0,1,1,1,0.5325,0.5252458333333333,0.58875,0.17600000000000002,664,3698,4362,Working Day
130,2011-05-10,2,0,5,0,2,1,1,0.5325,0.522721,0.489167,0.115671,694,4109,4803,2,0,5,0,2,1,1,0.5325000000000001,0.5227208333333333,0.4891666666666667,0.11567083333333333,694,4109,4803,Working Day
131,2011-05-11,2,0,5,0,3,1,1,0.5425,0.5284,0.632917,0.120642,550,3632,4182,2,0,5,0,3,1,2,0.5425,0.5284,0.6329166666666667,0.12064166666666666,550,3632,4182,Working Day
132,2011-05-12,2,0,5,0,4,1,1,0.535,0.523363,0.7475,0.189667,695,4169,4864,2,0,5,0,4,1,2,0.535,0.5233625000000001,0.7475,0.18966666666666665,695,4169,4864,Working Day
133,2011-05-13,2,0,5,0,5,1,2,0.5125,0.4943,0.863333,0.179725,692,3413,4105,2,0,5,0,5,1,2,0.5125000000000001,0.4943,0.8633333333333333,0.17972500000000002,692,3413,4105,Working Day
134,2011-05-14,2,0,5,0,6,0,2,0.520833,0.500629,0.9225,0.13495,902,2507,3409,2,0,5,0,6,0,2,0.5208333333333334,0.5006291666666667,0.9225,0.13495,902,2507,3409,Weekend
135,2011-05-15,2,0,5,0,0,0,2,0.5625,0.536,0.867083,0.152979,1582,2971,4553,2,0,5,0,0,0,2,0.5625,0.5359999999999999,0.8670833333333333,0.15297916666666667,1582,2971,4553,Weekend
136,2011-05-16,2,0,5,0,1,1,1,0.5775,0.550512,0.787917,0.126871,773,3185,3958,2,0,5,0,1,1,1,0.5775,0.5505125,0.7879166666666667,0.12687083333333335,773,3185,3958,Working Day
137,2011-05-17,2,0,5,0,2,1,2,0.561667,0.538529,0.837917,0.277354,678,3445,4123,2,0,5,0,2,1,2,0.5616666666666666,0.5385291666666666,0.8379166666666666,0.2773541666666666,678,3445,4123,Working Day
138,2011-05-18,2,0,5,0,3,1,2,0.55,0.527158,0.87,0.201492,536,3319,3855,2,0,5,0,3,1,2,0.55,0.5271583333333333,0.87,0.20149166666666665,536,3319,3855,Working Day
139,2011-05-19,2,0,5,0,4,1,2,0.530833,0.510742,0.829583,0.108213,735,3840,4575,2,0,5,0,4,1,1,0.5308333333333334,0.5107416666666666,0.8295833333333333,0.1082125,735,3840,4575,Working Day
140,2011-05-20,2,0,5,0,5,1,1,0.536667,0.529042,0.719583,0.125013,909,4008,4917,2,0,5,0,5,1,1,0.5366666666666667,0.5290416666666666,0.7195833333333334,0.1250125,909,4008,4917,Working Day
141,2011-05-21,2,0,5,0,6,0,1,0.6025,0.571975,0.626667,0.12065,2258,3547,5805,2,0,5,0,6,0,1,0.6025,0.571975,0.6266666666666666,0.12065,2258,3547,5805,Weekend
142,2011-05-22,2,0,5,0,0,0,1,0.604167,0.5745,0.749583,0.148008,1576,3084,4660,2,0,5,0,0,0,1,0.6041666666666666,0.5745,0.7495833333333333,0.14800833333333333,1576,3084,4660,Weekend
143,2011-05-23,2,0,5,0,1,1,2,0.631667,0.590296,0.81,0.233842,836,3438,4274,2,0,5,0,1,1,2,0.6316666666666667,0.5902958333333334,0.8099999999999999,0.23384166666666664,836,3438,4274,Working Day
144,2011-05-24,2,0,5,0,2,1,2,0.66,0.604813,0.740833,0.207092,659,3833,4492,2,0,5,0,2,1,2,0.66,0.6048125,0.7408333333333333,0.20709166666666667,659,3833,4492,Working Day
145,2011-05-25,2,0,5,0,3,1,1,0.660833,0.615542,0.69625,0.154233,740,4238,4978,2,0,5,0,3,1,3,0.6608333333333333,0.6155416666666667,0.69625,0.15423333333333333,740,4238,4978,Working Day
146,2011-05-26,2,0,5,0,4,1,1,0.708333,0.654688,0.6775,0.199642,758,3919,4677,2,0,5,0,4,1,1,0.7083333333333334,0.6546875,0.6775000000000001,0.1996416666666667,758,3919,4677,Working Day
147,2011-05-27,2,0,5,0,5,1,1,0.681667,0.637008,0.65375,0.240679,871,3808,4679,2,0,5,0,5,1,1,0.6816666666666666,0.6370083333333333,0.6537499999999999,0.24067916666666667,871,3808,4679,Working Day
148,2011-05-28,2,0,5,0,6,0,1,0.655833,0.612379,0.729583,0.230092,2001,2757,4758,2,0,5,0,6,0,1,0.6558333333333334,0.6123791666666666,0.7295833333333334,0.23009166666666667,2001,2757,4758,Weekend
149,2011-05-29,2,0,5,0,0,0,1,0.6675,0.61555,0.81875,0.213938,2355,2433,4788,2,0,5,0,0,0,1,0.6675,0.6155499999999999,0.81875,0.2139375,2355,2433,4788,Weekend
150,2011-05-30,2,0,5,1,1,0,1,0.733333,0.671092,0.685,0.131225,1549,2549,4098,2,0,5,1,1,0,1,0.7333333333333334,0.6710916666666668,0.6849999999999999,0.131225,1549,2549,4098,Holiday
151,2011-05-31,2,0,5,0,2,1,1,0.775,0.725383,0.636667,0.111329,673,3309,3982,2,0,5,0,2,1,1,0.775,0.7253833333333333,0.6366666666666666,0.11132916666666666,673,3309,3982,Working Day
152,2011-06-01,2,0,6,0,3,1,2,0.764167,0.720967,0.677083,0.207092,513,3461,3974,2,0,6,0,3,1,1,0.7641666666666667,0.7209666666666666,0.6770833333333334,0.20709166666666667,513,3461,3974,Working Day
153,2011-06-02,2,0,6,0,4,1,1,0.715,0.643942,0.305,0.292287,736,4232,4968,2,0,6,0,4,1,1,0.715,0.6439416666666666,0.305,0.2922875,736,4232,4968,Working Day
154,2011-06-03,2,0,6,0,5,1,1,0.62,0.587133,0.354167,0.253121,898,4414,5312,2,0,6,0,5,1,1,0.62,0.5871333333333333,0.3541666666666667,0.25312083333333335,898,4414,5312,Working Day
155,2011-06-04,2,0,6,0,6,0,1,0.635,0.594696,0.45625,0.123142,1869,3473,5342,2,0,6,0,6,0,1,0.635,0.5946958333333333,0.45625,0.12314166666666666,1869,3473,5342,Weekend
156,2011-06-05,2,0,6,0,0,0,2,0.648333,0.616804,0.6525,0.138692,1685,3221,4906,2,0,6,0,0,0,1,0.6483333333333333,0.6168041666666667,0.6525,0.13869166666666669,1685,3221,4906,Weekend
157,2011-06-06,2,0,6,0,1,1,1,0.678333,0.621858,0.6,0.121896,673,3875,4548,2,0,6,0,1,1,1,0.6783333333333333,0.6218583333333333,0.6,0.12189583333333333,673,3875,4548,Working Day
158,2011-06-07,2,0,6,0,2,1,1,0.7075,0.65595,0.597917,0.187808,763,4070,4833,2,0,6,0,2,1,1,0.7075,0.6559499999999999,0.5979166666666667,0.18780833333333333,763,4070,4833,Working Day
159,2011-06-08,2,0,6,0,3,1,1,0.775833,0.727279,0.622083,0.136817,676,3725,4401,2,0,6,0,3,1,1,0.7758333333333334,0.7272791666666666,0.6220833333333333,0.13681666666666667,676,3725,4401,Working Day
160,2011-06-09,2,0,6,0,4,1,2,0.808333,0.757579,0.568333,0.149883,563,3352,3915,2,0,6,0,4,1,2,0.8083333333333332,0.7575791666666666,0.5683333333333334,0.14988333333333334,563,3352,3915,Working Day
161,2011-06-10,2,0,6,0,5,1,1,0.755,0.703292,0.605,0.140554,815,3771,4586,2,0,6,0,5,1,3,0.755,0.7032916666666668,0.605,0.14055416666666667,815,3771,4586,Working Day
162,2011-06-11,2,0,6,0,6,0,1,0.725,0.678038,0.654583,0.15485,1729,3237,4966,2,0,6,0,6,0,1,0.725,0.6780375,0.6545833333333334,0.15485000000000002,1729,3237,4966,Weekend
163,2011-06-12,2,0,6,0,0,0,1,0.6925,0.643325,0.747917,0.163567,1467,2993,4460,2,0,6,0,0,0,1,0.6925,0.643325,0.7479166666666667,0.16356666666666667,1467,2993,4460,Weekend
164,2011-06-13,2,0,6,0,1,1,1,0.635,0.601654,0.494583,0.30535,863,4157,5020,2,0,6,0,1,1,1,0.635,0.6016541666666667,0.4945833333333333,0.30535,863,4157,5020,Working Day
165,2011-06-14,2,0,6,0,2,1,1,0.604167,0.591546,0.507083,0.269283,727,4164,4891,2,0,6,0,2,1,1,0.6041666666666666,0.5915458333333333,0.5070833333333333,0.2692833333333333,727,4164,4891,Working Day
166,2011-06-15,2,0,6,0,3,1,1,0.626667,0.587754,0.471667,0.167912,769,4411,5180,2,0,6,0,3,1,1,0.6266666666666666,0.5877541666666667,0.4716666666666667,0.16791250000000002,769,4411,5180,Working Day
167,2011-06-16,2,0,6,0,4,1,2,0.628333,0.595346,0.688333,0.206471,545,3222,3767,2,0,6,0,4,1,1,0.6283333333333333,0.5953458333333334,0.6883333333333334,0.20647083333333335,545,3222,3767,Working Day
168,2011-06-17,2,0,6,0,5,1,1,0.649167,0.600383,0.735833,0.143029,863,3981,4844,2,0,6,0,5,1,1,0.6491666666666667,0.6003833333333334,0.7358333333333333,0.14302916666666668,863,3981,4844,Working Day
169,2011-06-18,2,0,6,0,6,0,1,0.696667,0.643954,0.670417,0.119408,1807,3312,5119,2,0,6,0,6,0,1,0.6966666666666667,0.6439541666666666,0.6704166666666667,0.11940833333333334,1807,3312,5119,Weekend
170,2011-06-19,2,0,6,0,0,0,2,0.699167,0.645846,0.666667,0.102,1639,3105,4744,2,0,6,0,0,0,1,0.6991666666666667,0.6458458333333333,0.6666666666666666,0.102,1639,3105,4744,Weekend
171,2011-06-20,2,0,6,0,1,1,2,0.635,0.595346,0.74625,0.155475,699,3311,4010,2,0,6,0,1,1,1,0.635,0.5953458333333334,0.74625,0.155475,699,3311,4010,Working Day
172,2011-06-21,3,0,6,0,2,1,2,0.680833,0.637646,0.770417,0.171025,774,4061,4835,3,0,6,0,2,1,1,0.6808333333333333,0.6376458333333334,0.7704166666666666,0.17102499999999998,774,4061,4835,Working Day
173,2011-06-22,3,0,6,0,3,1,1,0.733333,0.693829,0.7075,0.172262,661,3846,4507,3,0,6,0,3,1,1,0.7333333333333334,0.6938291666666667,0.7075,0.17226249999999999,661,3846,4507,Working Day
174,2011-06-23,3,0,6,0,4,1,2,0.728333,0.693833,0.703333,0.238804,746,4044,4790,3,0,6,0,4,1,1,0.7283333333333334,0.6938333333333332,0.7033333333333333,0.23880416666666668,746,4044,4790,Working Day
175,2011-06-24,3,0,6,0,5,1,1,0.724167,0.656583,0.573333,0.222025,969,4022,4991,3,0,6,0,5,1,1,0.7241666666666666,0.6565833333333333,0.5733333333333334,0.222025,969,4022,4991,Working Day
176,2011-06-25,3,0,6,0,6,0,1,0.695,0.643313,0.483333,0.209571,1782,3420,5202,3,0,6,0,6,0,1,0.695,0.6433125,0.48333333333333334,0.20957083333333335,1782,3420,5202,Weekend
177,2011-06-26,3,0,6,0,0,0,1,0.68,0.637629,0.513333,0.0945333,1920,3385,5305,3,0,6,0,0,0,1,0.68,0.6376291666666666,0.5133333333333333,0.09453333333333334,1920,3385,5305,Weekend
178,2011-06-27,3,0,6,0,1,1,2,0.6825,0.637004,0.658333,0.107588,854,3854,4708,3,0,6,0,1,1,3,0.6825,0.6370041666666667,0.6583333333333333,0.1075875,854,3854,4708,Working Day
179,2011-06-28,3,0,6,0,2,1,1,0.744167,0.692558,0.634167,0.144283,732,3916,4648,3,0,6,0,2,1,2,0.7441666666666666,0.6925583333333334,0.6341666666666667,0.14428333333333335,732,3916,4648,Working Day
180,2011-06-29,3,0,6,0,3,1,1,0.728333,0.654688,0.497917,0.261821,848,4377,5225,3,0,6,0,3,1,2,0.7283333333333334,0.6546875,0.4979166666666666,0.26182083333333334,848,4377,5225,Working Day
181,2011-06-30,3,0,6,0,4,1,1,0.696667,0.637008,0.434167,0.185312,1027,4488,5515,3,0,6,0,4,1,1,0.6966666666666667,0.6370083333333333,0.43416666666666665,0.1853125,1027,4488,5515,Working Day
182,2011-07-01,3,0,7,0,5,1,1,0.7225,0.652162,0.39625,0.102608,1246,4116,5362,3,0,7,0,5,1,1,0.7225,0.6521625,0.39625,0.10260833333333334,1246,4116,5362,Working Day
183,2011-07-02,3,0,7,0,6,0,1,0.738333,0.667308,0.444583,0.115062,2204,2915,5119,3,0,7,0,6,0,1,0.7383333333333333,0.6673083333333333,0.44458333333333333,0.1150625,2204,2915,5119,Weekend
184,2011-07-03,3,0,7,0,0,0,2,0.716667,0.668575,0.6825,0.228858,2282,2367,4649,3,0,7,0,0,0,1,0.7166666666666667,0.668575,0.6825,0.2288583333333333,2282,2367,4649,Weekend
185,2011-07-04,3,0,7,1,1,0,2,0.726667,0.665417,0.637917,0.0814792,3065,2978,6043,3,0,7,1,1,0,1,0.7266666666666667,0.6654166666666667,0.6379166666666667,0.08147916666666667,3065,2978,6043,Holiday
186,2011-07-05,3,0,7,0,2,1,1,0.746667,0.696338,0.590417,0.126258,1031,3634,4665,3,0,7,0,2,1,2,0.7466666666666667,0.6963374999999999,0.5904166666666667,0.12625833333333333,1031,3634,4665,Working Day
187,2011-07-06,3,0,7,0,3,1,1,0.72,0.685633,0.743333,0.149883,784,3845,4629,3,0,7,0,3,1,1,0.7200000000000001,0.6856333333333332,0.7433333333333333,0.14988333333333334,784,3845,4629,Working Day
188,2011-07-07,3,0,7,0,4,1,1,0.75,0.686871,0.65125,0.1592,754,3838,4592,3,0,7,0,4,1,1,0.75,0.6868708333333333,0.65125,0.1592,754,3838,4592,Working Day
189,2011-07-08,3,0,7,0,5,1,2,0.709167,0.670483,0.757917,0.225129,692,3348,4040,3,0,7,0,5,1,1,0.7091666666666666,0.6704833333333333,0.7579166666666667,0.22512916666666669,692,3348,4040,Working Day
190,2011-07-09,3,0,7,0,6,0,1,0.733333,0.664158,0.609167,0.167912,1988,3348,5336,3,0,7,0,6,0,2,0.7333333333333334,0.6641583333333333,0.6091666666666666,0.16791250000000002,1988,3348,5336,Weekend
191,2011-07-10,3,0,7,0,0,0,1,0.7475,0.690025,0.578333,0.183471,1743,3138,4881,3,0,7,0,0,0,1,0.7475,0.690025,0.5783333333333334,0.18347083333333333,1743,3138,4881,Weekend
192,2011-07-11,3,0,7,0,1,1,1,0.7625,0.729804,0.635833,0.282337,723,3363,4086,3,0,7,0,1,1,1,0.7625000000000001,0.7298041666666667,0.6358333333333334,0.28233749999999996,723,3363,4086,Working Day
193,2011-07-12,3,0,7,0,2,1,1,0.794167,0.739275,0.559167,0.200254,662,3596,4258,3,0,7,0,2,1,1,0.7941666666666666,0.739275,0.5591666666666667,0.20025416666666665,662,3596,4258,Working Day
194,2011-07-13,3,0,7,0,3,1,1,0.746667,0.689404,0.631667,0.146133,748,3594,4342,3,0,7,0,3,1,1,0.7466666666666666,0.6894041666666667,0.6316666666666667,0.14613333333333334,748,3594,4342,Working Day
195,2011-07-14,3,0,7,0,4,1,1,0.680833,0.635104,0.47625,0.240667,888,4196,5084,3,0,7,0,4,1,1,0.6808333333333333,0.6351041666666667,0.47625,0.24066666666666667,888,4196,5084,Working Day
196,2011-07-15,3,0,7,0,5,1,1,0.663333,0.624371,0.59125,0.182833,1318,4220,5538,3,0,7,0,5,1,1,0.6633333333333333,0.6243708333333333,0.5912499999999999,0.18283333333333332,1318,4220,5538,Working Day
197,2011-07-16,3,0,7,0,6,0,1,0.686667,0.638263,0.585,0.208342,2418,3505,5923,3,0,7,0,6,0,1,0.6866666666666666,0.6382625,0.5850000000000001,0.20834166666666668,2418,3505,5923,Weekend
198,2011-07-17,3,0,7,0,0,0,1,0.719167,0.669833,0.604167,0.245033,2006,3296,5302,3,0,7,0,0,0,1,0.7191666666666667,0.6698333333333334,0.6041666666666666,0.24503333333333333,2006,3296,5302,Weekend
199,2011-07-18,3,0,7,0,1,1,1,0.746667,0.703925,0.65125,0.215804,841,3617,4458,3,0,7,0,1,1,1,0.7466666666666667,0.703925,0.65125,0.21580416666666669,841,3617,4458,Working Day
200,2011-07-19,3,0,7,0,2,1,1,0.776667,0.747479,0.650417,0.1306,752,3789,4541,3,0,7,0,2,1,1,0.7766666666666667,0.7474791666666666,0.6504166666666666,0.13060000000000002,752,3789,4541,Working Day
201,2011-07-20,3,0,7,0,3,1,1,0.768333,0.74685,0.707083,0.113817,644,3688,4332,3,0,7,0,3,1,1,0.7683333333333334,0.7468499999999999,0.7070833333333333,0.11381666666666666,644,3688,4332,Working Day
202,2011-07-21,3,0,7,0,4,1,2,0.815,0.826371,0.69125,0.222021,632,3152,3784,3,0,7,0,4,1,2,0.815,0.8263708333333333,0.69125,0.22202083333333333,632,3152,3784,Working Day
203,2011-07-22,3,0,7,0,5,1,1,0.848333,0.840896,0.580417,0.1331,562,2825,3387,3,0,7,0,5,1,1,0.8483333333333333,0.8408958333333333,0.5804166666666667,0.1331,562,2825,3387,Working Day
204,2011-07-23,3,0,7,0,6,0,1,0.849167,0.804287,0.5,0.131221,987,2298,3285,3,0,7,0,6,0,1,0.8491666666666666,0.8042875,0.5,0.13122083333333331,987,2298,3285,Weekend
205,2011-07-24,3,0,7,0,0,0,1,0.83,0.794829,0.550833,0.169171,1050,2556,3606,3,0,7,0,0,0,1,0.8300000000000001,0.7948291666666667,0.5508333333333334,0.16917083333333335,1050,2556,3606,Weekend
206,2011-07-25,3,0,7,0,1,1,1,0.743333,0.720958,0.757083,0.0908083,568,3272,3840,3,0,7,0,1,1,2,0.7433333333333333,0.7209583333333334,0.7570833333333332,0.09080833333333332,568,3272,3840,Working Day
207,2011-07-26,3,0,7,0,2,1,1,0.771667,0.696979,0.540833,0.200258,750,3840,4590,3,0,7,0,2,1,1,0.7716666666666666,0.6969791666666666,0.5408333333333334,0.20025833333333332,750,3840,4590,Working Day
208,2011-07-27,3,0,7,0,3,1,1,0.775,0.690667,0.402917,0.183463,755,3901,4656,3,0,7,0,3,1,2,0.775,0.6906666666666667,0.40291666666666665,0.1834625,755,3901,4656,Working Day
209,2011-07-28,3,0,7,0,4,1,1,0.779167,0.7399,0.583333,0.178479,606,3784,4390,3,0,7,0,4,1,1,0.7791666666666667,0.7399,0.5833333333333334,0.17847916666666666,606,3784,4390,Working Day
210,2011-07-29,3,0,7,0,5,1,1,0.838333,0.785967,0.5425,0.174138,670,3176,3846,3,0,7,0,5,1,1,0.8383333333333334,0.7859666666666666,0.5425,0.17413750000000003,670,3176,3846,Working Day
211,2011-07-30,3,0,7,0,6,0,1,0.804167,0.728537,0.465833,0.168537,1559,2916,4475,3,0,7,0,6,0,1,0.8041666666666667,0.7285375,0.4658333333333333,0.1685375,1559,2916,4475,Weekend
212,2011-07-31,3,0,7,0,0,0,1,0.805833,0.729796,0.480833,0.164813,1524,2778,4302,3,0,7,0,0,0,1,0.8058333333333333,0.7297958333333333,0.4808333333333333,0.1648125,1524,2778,4302,Weekend
213,2011-08-01,3,0,8,0,1,1,1,0.771667,0.703292,0.550833,0.156717,729,3537,4266,3,0,8,0,1,1,1,0.7716666666666666,0.7032916666666668,0.5508333333333333,0.15671666666666667,729,3537,4266,Working Day
214,2011-08-02,3,0,8,0,2,1,1,0.783333,0.707071,0.49125,0.20585,801,4044,4845,3,0,8,0,2,1,1,0.7833333333333333,0.7070708333333333,0.49124999999999996,0.20585,801,4044,4845,Working Day
215,2011-08-03,3,0,8,0,3,1,2,0.731667,0.679937,0.6575,0.135583,467,3107,3574,3,0,8,0,3,1,2,0.7316666666666666,0.6799375,0.6575,0.13558333333333333,467,3107,3574,Working Day
216,2011-08-04,3,0,8,0,4,1,2,0.71,0.664788,0.7575,0.19715,799,3777,4576,3,0,8,0,4,1,2,0.71,0.6647875,0.7575,0.19715000000000002,799,3777,4576,Working Day
217,2011-08-05,3,0,8,0,5,1,1,0.710833,0.656567,0.630833,0.184696,1023,3843,4866,3,0,8,0,5,1,1,0.7108333333333333,0.6565666666666666,0.6308333333333334,0.1846958333333333,1023,3843,4866,Working Day
218,2011-08-06,3,0,8,0,6,0,2,0.716667,0.676154,0.755,0.22825,1521,2773,4294,3,0,8,0,6,0,1,0.7166666666666667,0.6761541666666666,0.755,0.22824999999999998,1521,2773,4294,Weekend
219,2011-08-07,3,0,8,0,0,0,1,0.7425,0.715292,0.752917,0.201487,1298,2487,3785,3,0,8,0,0,0,2,0.7425,0.7152916666666665,0.7529166666666667,0.2014875,1298,2487,3785,Weekend
220,2011-08-08,3,0,8,0,1,1,1,0.765,0.703283,0.592083,0.192175,846,3480,4326,3,0,8,0,1,1,1,0.765,0.7032833333333333,0.5920833333333334,0.19217499999999998,846,3480,4326,Working Day
221,2011-08-09,3,0,8,0,2,1,1,0.775,0.724121,0.570417,0.151121,907,3695,4602,3,0,8,0,2,1,1,0.775,0.7241208333333334,0.5704166666666667,0.15112083333333334,907,3695,4602,Working Day
222,2011-08-10,3,0,8,0,3,1,1,0.766667,0.684983,0.424167,0.200258,884,3896,4780,3,0,8,0,3,1,1,0.7666666666666666,0.6849833333333333,0.42416666666666664,0.20025833333333332,884,3896,4780,Working Day
223,2011-08-11,3,0,8,0,4,1,1,0.7175,0.651521,0.42375,0.164796,812,3980,4792,3,0,8,0,4,1,1,0.7174999999999999,0.6515208333333333,0.42375,0.16479583333333334,812,3980,4792,Working Day
224,2011-08-12,3,0,8,0,5,1,1,0.708333,0.654042,0.415,0.125621,1051,3854,4905,3,0,8,0,5,1,1,0.7083333333333334,0.6540416666666666,0.41500000000000004,0.12562083333333332,1051,3854,4905,Working Day
225,2011-08-13,3,0,8,0,6,0,2,0.685833,0.645858,0.729583,0.211454,1504,2646,4150,3,0,8,0,6,0,1,0.6858333333333334,0.6458583333333333,0.7295833333333333,0.2114541666666667,1504,2646,4150,Weekend
226,2011-08-14,3,0,8,0,0,0,2,0.676667,0.624388,0.8175,0.222633,1338,2482,3820,3,0,8,0,0,0,3,0.6766666666666666,0.6243875,0.8175,0.22263333333333335,1338,2482,3820,Weekend
227,2011-08-15,3,0,8,0,1,1,1,0.665833,0.616167,0.712083,0.208954,775,3563,4338,3,0,8,0,1,1,3,0.6658333333333334,0.6161666666666666,0.7120833333333333,0.20895416666666666,775,3563,4338,Working Day
228,2011-08-16,3,0,8,0,2,1,1,0.700833,0.645837,0.578333,0.236329,721,4004,4725,3,0,8,0,2,1,1,0.7008333333333333,0.6458375,0.5783333333333333,0.23632916666666667,721,4004,4725,Working Day
229,2011-08-17,3,0,8,0,3,1,1,0.723333,0.666671,0.575417,0.143667,668,4026,4694,3,0,8,0,3,1,1,0.7233333333333333,0.6666708333333333,0.5754166666666667,0.14366666666666666,668,4026,4694,Working Day
230,2011-08-18,3,0,8,0,4,1,1,0.711667,0.662258,0.654583,0.233208,639,3166,3805,3,0,8,0,4,1,1,0.7116666666666668,0.6622583333333333,0.6545833333333334,0.23320833333333335,639,3166,3805,Working Day
231,2011-08-19,3,0,8,0,5,1,2,0.685,0.633221,0.722917,0.139308,797,3356,4153,3,0,8,0,5,1,3,0.685,0.6332208333333332,0.7229166666666668,0.13930833333333334,797,3356,4153,Working Day
232,2011-08-20,3,0,8,0,6,0,1,0.6975,0.648996,0.674167,0.104467,1914,3277,5191,3,0,8,0,6,0,1,0.6974999999999999,0.6489958333333333,0.6741666666666667,0.10446666666666667,1914,3277,5191,Weekend
233,2011-08-21,3,0,8,0,0,0,1,0.710833,0.675525,0.77,0.248754,1249,2624,3873,3,0,8,0,0,0,1,0.7108333333333333,0.6755249999999999,0.77,0.2487541666666667,1249,2624,3873,Weekend
234,2011-08-22,3,0,8,0,1,1,1,0.691667,0.638254,0.47,0.27675,833,3925,4758,3,0,8,0,1,1,1,0.6916666666666668,0.6382541666666667,0.47,0.27675,833,3925,4758,Working Day
235,2011-08-23,3,0,8,0,2,1,1,0.640833,0.606067,0.455417,0.146763,1281,4614,5895,3,0,8,0,2,1,1,0.6408333333333333,0.6060666666666666,0.45541666666666664,0.1467625,1281,4614,5895,Working Day
236,2011-08-24,3,0,8,0,3,1,1,0.673333,0.630692,0.605,0.253108,949,4181,5130,3,0,8,0,3,1,1,0.6733333333333333,0.6306916666666667,0.605,0.2531083333333333,949,4181,5130,Working Day
237,2011-08-25,3,0,8,0,4,1,2,0.684167,0.645854,0.771667,0.210833,435,3107,3542,3,0,8,0,4,1,1,0.6841666666666667,0.6458541666666666,0.7716666666666666,0.21083333333333334,435,3107,3542,Working Day
238,2011-08-26,3,0,8,0,5,1,1,0.7,0.659733,0.76125,0.0839625,768,3893,4661,3,0,8,0,5,1,1,0.7000000000000001,0.6597333333333333,0.76125,0.0839625,768,3893,4661,Working Day
239,2011-08-27,3,0,8,0,6,0,2,0.68,0.635556,0.85,0.375617,226,889,1115,3,0,8,0,6,0,1,0.68,0.6355555555555555,0.85,0.37561666666666665,226,889,1115,Weekend
240,2011-08-28,3,0,8,0,0,0,1,0.707059,0.647959,0.561765,0.304659,1415,2919,4334,3,0,8,0,0,0,3,0.7070588235294117,0.6479588235294118,0.5617647058823529,0.30465882352941176,1415,2919,4334,Weekend
241,2011-08-29,3,0,8,0,1,1,1,0.636667,0.607958,0.554583,0.159825,729,3905,4634,3,0,8,0,1,1,1,0.6366666666666666,0.6079583333333333,0.5545833333333333,0.159825,729,3905,4634,Working Day
242,2011-08-30,3,0,8,0,2,1,1,0.639167,0.594704,0.548333,0.125008,775,4429,5204,3,0,8,0,2,1,1,0.6391666666666667,0.5947041666666667,0.5483333333333333,0.12500833333333333,775,4429,5204,Working Day
243,2011-08-31,3,0,8,0,3,1,1,0.656667,0.611121,0.597917,0.0833333,688,4370,5058,3,0,8,0,3,1,1,0.6566666666666666,0.6111208333333333,0.5979166666666667,0.08333333333333333,688,4370,5058,Working Day
244,2011-09-01,3,0,9,0,4,1,1,0.655,0.614921,0.639167,0.141796,783,4332,5115,3,0,9,0,4,1,1,0.655,0.6149208333333332,0.6391666666666667,0.14179583333333332,783,4332,5115,Working Day
245,2011-09-02,3,0,9,0,5,1,2,0.643333,0.604808,0.727083,0.139929,875,3852,4727,3,0,9,0,5,1,1,0.6433333333333333,0.6048083333333333,0.7270833333333333,0.13992916666666666,875,3852,4727,Working Day
246,2011-09-03,3,0,9,0,6,0,1,0.669167,0.633213,0.716667,0.185325,1935,2549,4484,3,0,9,0,6,0,2,0.6691666666666666,0.6332125,0.7166666666666667,0.185325,1935,2549,4484,Weekend
247,2011-09-04,3,0,9,0,0,0,1,0.709167,0.665429,0.742083,0.206467,2521,2419,4940,3,0,9,0,0,0,1,0.7091666666666666,0.6654291666666666,0.7420833333333333,0.2064666666666667,2521,2419,4940,Weekend
248,2011-09-05,3,0,9,1,1,0,2,0.673333,0.625646,0.790417,0.212696,1236,2115,3351,3,0,9,1,1,0,2,0.6733333333333333,0.6256458333333333,0.7904166666666667,0.21269583333333333,1236,2115,3351,Holiday
249,2011-09-06,3,0,9,0,2,1,3,0.54,0.5152,0.886957,0.343943,204,2506,2710,3,0,9,0,2,1,3,0.54,0.5152,0.8869565217391304,0.3439434782608696,204,2506,2710,Working Day
250,2011-09-07,3,0,9,0,3,1,3,0.599167,0.544229,0.917083,0.0970208,118,1878,1996,3,0,9,0,3,1,2,0.5991666666666667,0.5442291666666667,0.9170833333333333,0.09702083333333333,118,1878,1996,Working Day
251,2011-09-08,3,0,9,0,4,1,3,0.633913,0.555361,0.939565,0.192748,153,1689,1842,3,0,9,0,4,1,3,0.6339130434782608,0.5553608695652174,0.9395652173913043,0.19274782608695654,153,1689,1842,Working Day
252,2011-09-09,3,0,9,0,5,1,2,0.65,0.578946,0.897917,0.124379,417,3127,3544,3,0,9,0,5,1,3,0.65,0.5789458333333334,0.8979166666666667,0.12437916666666667,417,3127,3544,Working Day
253,2011-09-10,3,0,9,0,6,0,1,0.66,0.607962,0.75375,0.153608,1750,3595,5345,3,0,9,0,6,0,1,0.66,0.6079625,0.75375,0.15360833333333332,1750,3595,5345,Weekend
254,2011-09-11,3,0,9,0,0,0,1,0.653333,0.609229,0.71375,0.115054,1633,3413,5046,3,0,9,0,0,0,1,0.6533333333333333,0.6092291666666666,0.71375,0.11505416666666667,1633,3413,5046,Weekend
255,2011-09-12,3,0,9,0,1,1,1,0.644348,0.60213,0.692174,0.088913,690,4023,4713,3,0,9,0,1,1,1,0.6443478260869565,0.6021304347826087,0.6921739130434783,0.08891304347826087,690,4023,4713,Working Day
256,2011-09-13,3,0,9,0,2,1,1,0.650833,0.603554,0.7125,0.141804,701,4062,4763,3,0,9,0,2,1,1,0.6508333333333333,0.6035541666666666,0.7125,0.14180416666666668,701,4062,4763,Working Day
257,2011-09-14,3,0,9,0,3,1,1,0.673333,0.6269,0.697083,0.1673,647,4138,4785,3,0,9,0,3,1,1,0.6733333333333333,0.6268999999999999,0.6970833333333334,0.1673,647,4138,4785,Working Day
258,2011-09-15,3,0,9,0,4,1,2,0.5775,0.553671,0.709167,0.271146,428,3231,3659,3,0,9,0,4,1,1,0.5775,0.5536708333333333,0.7091666666666666,0.27114583333333336,428,3231,3659,Working Day
259,2011-09-16,3,0,9,0,5,1,2,0.469167,0.461475,0.590417,0.164183,742,4018,4760,3,0,9,0,5,1,1,0.4691666666666667,0.461475,0.5904166666666667,0.16418333333333332,742,4018,4760,Working Day
260,2011-09-17,3,0,9,0,6,0,2,0.491667,0.478512,0.718333,0.189675,1434,3077,4511,3,0,9,0,6,0,1,0.4916666666666667,0.47851250000000006,0.7183333333333333,0.189675,1434,3077,4511,Weekend
261,2011-09-18,3,0,9,0,0,0,1,0.5075,0.490537,0.695,0.178483,1353,2921,4274,3,0,9,0,0,0,1,0.5075,0.4905375,0.695,0.17848333333333333,1353,2921,4274,Weekend
262,2011-09-19,3,0,9,0,1,1,2,0.549167,0.529675,0.69,0.151742,691,3848,4539,3,0,9,0,1,1,2,0.5491666666666667,0.529675,0.69,0.15174166666666666,691,3848,4539,Working Day
263,2011-09-20,3,0,9,0,2,1,2,0.561667,0.532217,0.88125,0.134954,438,3203,3641,3,0,9,0,2,1,2,0.5616666666666666,0.5322166666666667,0.88125,0.13495416666666668,438,3203,3641,Working Day
264,2011-09-21,3,0,9,0,3,1,2,0.595,0.550533,0.9,0.0964042,539,3813,4352,3,0,9,0,3,1,1,0.5950000000000001,0.5505333333333333,0.9,0.09640416666666667,539,3813,4352,Working Day
265,2011-09-22,3,0,9,0,4,1,2,0.628333,0.554963,0.902083,0.128125,555,4240,4795,3,0,9,0,4,1,1,0.6283333333333333,0.5549624999999999,0.9020833333333332,0.12812500000000002,555,4240,4795,Working Day
266,2011-09-23,4,0,9,0,5,1,2,0.609167,0.522125,0.9725,0.0783667,258,2137,2395,4,0,9,0,5,1,2,0.6091666666666666,0.5221250000000001,0.9725,0.07836666666666667,258,2137,2395,Working Day
267,2011-09-24,4,0,9,0,6,0,2,0.606667,0.564412,0.8625,0.0783833,1776,3647,5423,4,0,9,0,6,0,1,0.6066666666666667,0.5644125,0.8624999999999999,0.07838333333333333,1776,3647,5423,Weekend
268,2011-09-25,4,0,9,0,0,0,2,0.634167,0.572637,0.845,0.0503792,1544,3466,5010,4,0,9,0,0,0,2,0.6341666666666667,0.5726375,0.8450000000000001,0.05037916666666667,1544,3466,5010,Weekend
269,2011-09-26,4,0,9,0,1,1,2,0.649167,0.589042,0.848333,0.1107,684,3946,4630,4,0,9,0,1,1,2,0.6491666666666667,0.5890416666666666,0.8483333333333333,0.1107,684,3946,4630,Working Day
270,2011-09-27,4,0,9,0,2,1,2,0.636667,0.574525,0.885417,0.118171,477,3643,4120,4,0,9,0,2,1,1,0.6366666666666666,0.574525,0.8854166666666666,0.11817083333333334,477,3643,4120,Working Day
271,2011-09-28,4,0,9,0,3,1,2,0.635,0.575158,0.84875,0.148629,480,3427,3907,4,0,9,0,3,1,1,0.635,0.5751583333333333,0.84875,0.14862916666666667,480,3427,3907,Working Day
272,2011-09-29,4,0,9,0,4,1,1,0.616667,0.574512,0.699167,0.172883,653,4186,4839,4,0,9,0,4,1,1,0.6166666666666667,0.5745125,0.6991666666666667,0.17288333333333336,653,4186,4839,Working Day
273,2011-09-30,4,0,9,0,5,1,1,0.564167,0.544829,0.6475,0.206475,830,4372,5202,4,0,9,0,5,1,1,0.5641666666666667,0.5448291666666666,0.6475,0.206475,830,4372,5202,Working Day
274,2011-10-01,4,0,10,0,6,0,2,0.41,0.412863,0.75375,0.292296,480,1949,2429,4,0,10,0,6,0,1,0.41,0.41286249999999997,0.75375,0.29229583333333337,480,1949,2429,Weekend
275,2011-10-02,4,0,10,0,0,0,2,0.356667,0.345317,0.791667,0.222013,616,2302,2918,4,0,10,0,0,0,3,0.3566666666666667,0.34531666666666666,0.7916666666666666,0.22201249999999997,616,2302,2918,Weekend
276,2011-10-03,4,0,10,0,1,1,2,0.384167,0.392046,0.760833,0.0833458,330,3240,3570,4,0,10,0,1,1,1,0.3841666666666667,0.39204583333333337,0.7608333333333334,0.08334583333333334,330,3240,3570,Working Day
277,2011-10-04,4,0,10,0,2,1,1,0.484167,0.472858,0.71,0.205854,486,3970,4456,4,0,10,0,2,1,2,0.4841666666666667,0.4728583333333333,0.71,0.20585416666666667,486,3970,4456,Working Day
278,2011-10-05,4,0,10,0,3,1,1,0.538333,0.527138,0.647917,0.17725,559,4267,4826,4,0,10,0,3,1,1,0.5383333333333333,0.5271374999999999,0.6479166666666667,0.17725000000000002,559,4267,4826,Working Day
279,2011-10-06,4,0,10,0,4,1,1,0.494167,0.480425,0.620833,0.134954,639,4126,4765,4,0,10,0,4,1,1,0.49416666666666664,0.48042500000000005,0.6208333333333333,0.13495416666666668,639,4126,4765,Working Day
280,2011-10-07,4,0,10,0,5,1,1,0.510833,0.504404,0.684167,0.0223917,949,4036,4985,4,0,10,0,5,1,1,0.5108333333333334,0.5044041666666667,0.6841666666666667,0.022391666666666667,949,4036,4985,Working Day
281,2011-10-08,4,0,10,0,6,0,1,0.521667,0.513242,0.70125,0.0454042,2235,3174,5409,4,0,10,0,6,0,1,0.5216666666666666,0.5132416666666667,0.7012499999999999,0.04540416666666667,2235,3174,5409,Weekend
282,2011-10-09,4,0,10,0,0,0,1,0.540833,0.523983,0.7275,0.06345,2397,3114,5511,4,0,10,0,0,0,1,0.5408333333333334,0.5239833333333334,0.7275,0.06344999999999999,2397,3114,5511,Weekend
283,2011-10-10,4,0,10,1,1,0,1,0.570833,0.542925,0.73375,0.0423042,1514,3603,5117,4,0,10,1,1,0,1,0.5708333333333333,0.542925,0.73375,0.04230416666666667,1514,3603,5117,Holiday
284,2011-10-11,4,0,10,0,2,1,2,0.566667,0.546096,0.80875,0.143042,667,3896,4563,4,0,10,0,2,1,2,0.5666666666666667,0.5460958333333333,0.80875,0.14304166666666665,667,3896,4563,Working Day
285,2011-10-12,4,0,10,0,3,1,3,0.543333,0.517717,0.90625,0.24815,217,2199,2416,4,0,10,0,3,1,2,0.5433333333333333,0.5177166666666667,0.90625,0.24815,217,2199,2416,Working Day
286,2011-10-13,4,0,10,0,4,1,2,0.589167,0.551804,0.896667,0.141787,290,2623,2913,4,0,10,0,4,1,2,0.5891666666666667,0.5518041666666667,0.8966666666666666,0.14178749999999998,290,2623,2913,Working Day
287,2011-10-14,4,0,10,0,5,1,2,0.550833,0.529675,0.71625,0.223883,529,3115,3644,4,0,10,0,5,1,1,0.5508333333333334,0.529675,0.71625,0.22388333333333335,529,3115,3644,Working Day
288,2011-10-15,4,0,10,0,6,0,1,0.506667,0.498725,0.483333,0.258083,1899,3318,5217,4,0,10,0,6,0,1,0.5066666666666667,0.49872500000000003,0.48333333333333334,0.25808333333333333,1899,3318,5217,Weekend
289,2011-10-16,4,0,10,0,0,0,1,0.511667,0.503154,0.486667,0.281717,1748,3293,5041,4,0,10,0,0,0,1,0.5116666666666667,0.5031541666666667,0.48666666666666664,0.28171666666666667,1748,3293,5041,Weekend
290,2011-10-17,4,0,10,0,1,1,1,0.534167,0.510725,0.579583,0.175379,713,3857,4570,4,0,10,0,1,1,1,0.5341666666666667,0.510725,0.5795833333333333,0.17537916666666667,713,3857,4570,Working Day
291,2011-10-18,4,0,10,0,2,1,2,0.5325,0.522721,0.701667,0.110087,637,4111,4748,4,0,10,0,2,1,1,0.5325000000000001,0.5227208333333333,0.7016666666666667,0.1100875,637,4111,4748,Working Day
292,2011-10-19,4,0,10,0,3,1,3,0.541739,0.513848,0.895217,0.243339,254,2170,2424,4,0,10,0,3,1,2,0.5417391304347826,0.5138478260869566,0.8952173913043479,0.2433391304347826,254,2170,2424,Working Day
293,2011-10-20,4,0,10,0,4,1,1,0.475833,0.466525,0.63625,0.422275,471,3724,4195,4,0,10,0,4,1,1,0.47583333333333333,0.466525,0.63625,0.42227499999999996,471,3724,4195,Working Day
294,2011-10-21,4,0,10,0,5,1,1,0.4275,0.423596,0.574167,0.221396,676,3628,4304,4,0,10,0,5,1,1,0.4275,0.42359583333333334,0.5741666666666666,0.22139583333333335,676,3628,4304,Working Day
295,2011-10-22,4,0,10,0,6,0,1,0.4225,0.425492,0.629167,0.0926667,1499,2809,4308,4,0,10,0,6,0,1,0.42250000000000004,0.42549166666666666,0.6291666666666667,0.09266666666666666,1499,2809,4308,Weekend
296,2011-10-23,4,0,10,0,0,0,1,0.421667,0.422333,0.74125,0.0995125,1619,2762,4381,4,0,10,0,0,0,1,0.4216666666666667,0.4223333333333333,0.74125,0.0995125,1619,2762,4381,Weekend
297,2011-10-24,4,0,10,0,1,1,1,0.463333,0.457067,0.772083,0.118792,699,3488,4187,4,0,10,0,1,1,1,0.4633333333333334,0.4570666666666667,0.7720833333333333,0.11879166666666667,699,3488,4187,Working Day
298,2011-10-25,4,0,10,0,2,1,1,0.471667,0.463375,0.622917,0.166658,695,3992,4687,4,0,10,0,2,1,1,0.4716666666666667,0.46337500000000004,0.6229166666666667,0.16665833333333332,695,3992,4687,Working Day
299,2011-10-26,4,0,10,0,3,1,2,0.484167,0.472846,0.720417,0.148642,404,3490,3894,4,0,10,0,3,1,1,0.48416666666666663,0.47284583333333335,0.7204166666666666,0.14864166666666667,404,3490,3894,Working Day
300,2011-10-27,4,0,10,0,4,1,2,0.47,0.457046,0.812917,0.197763,240,2419,2659,4,0,10,0,4,1,1,0.47,0.4570458333333334,0.8129166666666666,0.19776249999999998,240,2419,2659,Working Day
301,2011-10-28,4,0,10,0,5,1,2,0.330833,0.318812,0.585833,0.229479,456,3291,3747,4,0,10,0,5,1,1,0.33083333333333337,0.3188125,0.5858333333333333,0.22947916666666668,456,3291,3747,Working Day
302,2011-10-29,4,0,10,0,6,0,3,0.254167,0.227913,0.8825,0.351371,57,570,627,4,0,10,0,6,0,3,0.25416666666666665,0.2279125,0.8825,0.35137083333333335,57,570,627,Weekend
303,2011-10-30,4,0,10,0,0,0,1,0.319167,0.321329,0.62375,0.176617,885,2446,3331,4,0,10,0,0,0,1,0.31916666666666665,0.32132916666666667,0.62375,0.17661666666666667,885,2446,3331,Weekend
304,2011-10-31,4,0,10,0,1,1,1,0.34,0.356063,0.703333,0.10635,362,3307,3669,4,0,10,0,1,1,1,0.34,0.3560625,0.7033333333333333,0.10635,362,3307,3669,Working Day
305,2011-11-01,4,0,11,0,2,1,1,0.400833,0.397088,0.68375,0.135571,410,3658,4068,4,0,11,0,2,1,2,0.4008333333333333,0.39708750000000004,0.68375,0.13557083333333333,410,3658,4068,Working Day
306,2011-11-02,4,0,11,0,3,1,1,0.3775,0.390133,0.71875,0.0820917,370,3816,4186,4,0,11,0,3,1,1,0.3775,0.3901333333333333,0.71875,0.08209166666666667,370,3816,4186,Working Day
307,2011-11-03,4,0,11,0,4,1,1,0.408333,0.405921,0.702083,0.136817,318,3656,3974,4,0,11,0,4,1,1,0.4083333333333334,0.40592083333333334,0.7020833333333334,0.13681666666666667,318,3656,3974,Working Day
308,2011-11-04,4,0,11,0,5,1,2,0.403333,0.403392,0.6225,0.271779,470,3576,4046,4,0,11,0,5,1,2,0.4033333333333333,0.40339166666666665,0.6224999999999999,0.2717791666666667,470,3576,4046,Working Day
309,2011-11-05,4,0,11,0,6,0,1,0.326667,0.323854,0.519167,0.189062,1156,2770,3926,4,0,11,0,6,0,1,0.32666666666666666,0.32385416666666667,0.5191666666666667,0.1890625,1156,2770,3926,Weekend
310,2011-11-06,4,0,11,0,0,0,1,0.348333,0.362358,0.734583,0.0920542,952,2697,3649,4,0,11,0,0,0,1,0.34833333333333333,0.36235833333333334,0.7345833333333333,0.09205416666666666,952,2697,3649,Weekend
311,2011-11-07,4,0,11,0,1,1,1,0.395,0.400871,0.75875,0.057225,373,3662,4035,4,0,11,0,1,1,1,0.395,0.40087083333333334,0.75875,0.057225,373,3662,4035,Working Day
312,2011-11-08,4,0,11,0,2,1,1,0.408333,0.412246,0.721667,0.0690375,376,3829,4205,4,0,11,0,2,1,1,0.4083333333333334,0.41224583333333337,0.7216666666666667,0.0690375,376,3829,4205,Working Day
313,2011-11-09,4,0,11,0,3,1,1,0.4,0.409079,0.758333,0.0621958,305,3804,4109,4,0,11,0,3,1,1,0.39999999999999997,0.40907916666666666,0.7583333333333333,0.06219583333333333,305,3804,4109,Working Day
314,2011-11-10,4,0,11,0,4,1,2,0.38,0.373721,0.813333,0.189067,190,2743,2933,4,0,11,0,4,1,1,0.37999999999999995,0.37372083333333334,0.8133333333333334,0.1890666666666667,190,2743,2933,Working Day
315,2011-11-11,4,0,11,1,5,0,1,0.324167,0.306817,0.44625,0.314675,440,2928,3368,4,0,11,1,5,0,1,0.32416666666666666,0.3068166666666667,0.44625000000000004,0.314675,440,2928,3368,Holiday
316,2011-11-12,4,0,11,0,6,0,1,0.356667,0.357942,0.552917,0.212062,1275,2792,4067,4,0,11,0,6,0,1,0.3566666666666667,0.35794166666666666,0.5529166666666666,0.21206250000000001,1275,2792,4067,Weekend
317,2011-11-13,4,0,11,0,0,0,1,0.440833,0.43055,0.458333,0.281721,1004,2713,3717,4,0,11,0,0,0,2,0.44083333333333335,0.43055,0.4583333333333333,0.28172083333333336,1004,2713,3717,Weekend
318,2011-11-14,4,0,11,0,1,1,1,0.53,0.524612,0.587083,0.306596,595,3891,4486,4,0,11,0,1,1,1,0.53,0.5246125,0.5870833333333333,0.30659583333333335,595,3891,4486,Working Day
319,2011-11-15,4,0,11,0,2,1,2,0.53,0.507579,0.68875,0.199633,449,3746,4195,4,0,11,0,2,1,1,0.53,0.5075791666666667,0.6887500000000001,0.19963333333333333,449,3746,4195,Working Day
320,2011-11-16,4,0,11,0,3,1,3,0.456667,0.451988,0.93,0.136829,145,1672,1817,4,0,11,0,3,1,2,0.4566666666666667,0.4519875,0.93,0.13682916666666667,145,1672,1817,Working Day
321,2011-11-17,4,0,11,0,4,1,2,0.341667,0.323221,0.575833,0.305362,139,2914,3053,4,0,11,0,4,1,2,0.3416666666666666,0.32322083333333335,0.5758333333333333,0.3053625,139,2914,3053,Working Day
322,2011-11-18,4,0,11,0,5,1,1,0.274167,0.272721,0.41,0.168533,245,3147,3392,4,0,11,0,5,1,1,0.27416666666666667,0.27272083333333336,0.41,0.16853333333333334,245,3147,3392,Working Day
323,2011-11-19,4,0,11,0,6,0,1,0.329167,0.324483,0.502083,0.224496,943,2720,3663,4,0,11,0,6,0,1,0.32916666666666666,0.32448333333333335,0.5020833333333333,0.22449583333333334,943,2720,3663,Weekend
324,2011-11-20,4,0,11,0,0,0,2,0.463333,0.457058,0.684583,0.18595,787,2733,3520,4,0,11,0,0,0,1,0.4633333333333334,0.45705833333333334,0.6845833333333333,0.18594999999999998,787,2733,3520,Weekend
325,2011-11-21,4,0,11,0,1,1,3,0.4475,0.445062,0.91,0.138054,220,2545,2765,4,0,11,0,1,1,2,0.4475,0.44506249999999997,0.91,0.13805416666666667,220,2545,2765,Working Day
326,2011-11-22,4,0,11,0,2,1,3,0.416667,0.421696,0.9625,0.118792,69,1538,1607,4,0,11,0,2,1,3,0.4166666666666667,0.4216958333333333,0.9624999999999999,0.11879166666666667,69,1538,1607,Working Day
327,2011-11-23,4,0,11,0,3,1,2,0.440833,0.430537,0.757917,0.335825,112,2454,2566,4,0,11,0,3,1,2,0.44083333333333335,0.4305375,0.7579166666666666,0.335825,112,2454,2566,Working Day
328,2011-11-24,4,0,11,1,4,0,1,0.373333,0.372471,0.549167,0.167304,560,935,1495,4,0,11,1,4,0,1,0.37333333333333335,0.3724708333333333,0.5491666666666667,0.16730416666666667,560,935,1495,Holiday
329,2011-11-25,4,0,11,0,5,1,1,0.375,0.380671,0.64375,0.0988958,1095,1697,2792,4,0,11,0,5,1,1,0.375,0.38067083333333335,0.64375,0.09889583333333334,1095,1697,2792,Working Day
330,2011-11-26,4,0,11,0,6,0,1,0.375833,0.385087,0.681667,0.0684208,1249,1819,3068,4,0,11,0,6,0,1,0.3758333333333333,0.3850875,0.6816666666666666,0.06842083333333333,1249,1819,3068,Weekend
331,2011-11-27,4,0,11,0,0,0,1,0.459167,0.4558,0.698333,0.208954,810,2261,3071,4,0,11,0,0,0,1,0.45916666666666667,0.4558,0.6983333333333334,0.20895416666666666,810,2261,3071,Weekend
332,2011-11-28,4,0,11,0,1,1,1,0.503478,0.490122,0.743043,0.142122,253,3614,3867,4,0,11,0,1,1,1,0.5034782608695653,0.4901217391304348,0.7430434782608696,0.14212173913043477,253,3614,3867,Working Day
333,2011-11-29,4,0,11,0,2,1,2,0.458333,0.451375,0.830833,0.258092,96,2818,2914,4,0,11,0,2,1,1,0.4583333333333333,0.451375,0.8308333333333334,0.25809166666666666,96,2818,2914,Working Day
334,2011-11-30,4,0,11,0,3,1,1,0.325,0.311221,0.613333,0.271158,188,3425,3613,4,0,11,0,3,1,1,0.325,0.31122083333333334,0.6133333333333334,0.27115833333333333,188,3425,3613,Working Day
335,2011-12-01,4,0,12,0,4,1,1,0.3125,0.305554,0.524583,0.220158,182,3545,3727,4,0,12,0,4,1,1,0.3125,0.3055541666666666,0.5245833333333333,0.22015833333333334,182,3545,3727,Working Day
336,2011-12-02,4,0,12,0,5,1,1,0.314167,0.331433,0.625833,0.100754,268,3672,3940,4,0,12,0,5,1,1,0.31416666666666665,0.3314333333333333,0.6258333333333334,0.10075416666666666,268,3672,3940,Working Day
337,2011-12-03,4,0,12,0,6,0,1,0.299167,0.310604,0.612917,0.0957833,706,2908,3614,4,0,12,0,6,0,1,0.29916666666666664,0.3106041666666666,0.6129166666666667,0.09578333333333333,706,2908,3614,Weekend
338,2011-12-04,4,0,12,0,0,0,1,0.330833,0.3491,0.775833,0.0839583,634,2851,3485,4,0,12,0,0,0,1,0.33083333333333337,0.34909999999999997,0.7758333333333334,0.08395833333333334,634,2851,3485,Weekend
339,2011-12-05,4,0,12,0,1,1,2,0.385833,0.393925,0.827083,0.0622083,233,3578,3811,4,0,12,0,1,1,1,0.3858333333333333,0.393925,0.8270833333333334,0.06220833333333333,233,3578,3811,Working Day
340,2011-12-06,4,0,12,0,2,1,3,0.4625,0.4564,0.949583,0.232583,126,2468,2594,4,0,12,0,2,1,2,0.46249999999999997,0.4564,0.9495833333333333,0.23258333333333334,126,2468,2594,Working Day
341,2011-12-07,4,0,12,0,3,1,3,0.41,0.400246,0.970417,0.266175,50,655,705,4,0,12,0,3,1,1,0.41,0.40024583333333336,0.9704166666666666,0.266175,50,655,705,Working Day
342,2011-12-08,4,0,12,0,4,1,1,0.265833,0.256938,0.58,0.240058,150,3172,3322,4,0,12,0,4,1,2,0.2658333333333333,0.2569375,0.58,0.24005833333333335,150,3172,3322,Working Day
343,2011-12-09,4,0,12,0,5,1,1,0.290833,0.317542,0.695833,0.0827167,261,3359,3620,4,0,12,0,5,1,1,0.29083333333333333,0.31754166666666667,0.6958333333333333,0.08271666666666667,261,3359,3620,Working Day
344,2011-12-10,4,0,12,0,6,0,1,0.275,0.266412,0.5075,0.233221,502,2688,3190,4,0,12,0,6,0,2,0.275,0.2664125,0.5075,0.23322083333333332,502,2688,3190,Weekend
345,2011-12-11,4,0,12,0,0,0,1,0.220833,0.253154,0.49,0.0665417,377,2366,2743,4,0,12,0,0,0,1,0.22083333333333333,0.2531541666666666,0.49,0.06654166666666667,377,2366,2743,Weekend
346,2011-12-12,4,0,12,0,1,1,1,0.238333,0.270196,0.670833,0.06345,143,3167,3310,4,0,12,0,1,1,1,0.2383333333333333,0.27019583333333336,0.6708333333333334,0.06344999999999999,143,3167,3310,Working Day
347,2011-12-13,4,0,12,0,2,1,1,0.2825,0.301138,0.59,0.14055,155,3368,3523,4,0,12,0,2,1,1,0.28250000000000003,0.3011375,0.59,0.14055,155,3368,3523,Working Day
348,2011-12-14,4,0,12,0,3,1,2,0.3175,0.338362,0.66375,0.0609583,178,3562,3740,4,0,12,0,3,1,1,0.3175,0.33836249999999995,0.66375,0.06095833333333334,178,3562,3740,Working Day
349,2011-12-15,4,0,12,0,4,1,2,0.4225,0.412237,0.634167,0.268042,181,3528,3709,4,0,12,0,4,1,1,0.42250000000000004,0.4122375,0.6341666666666667,0.2680416666666667,181,3528,3709,Working Day
350,2011-12-16,4,0,12,0,5,1,2,0.375,0.359825,0.500417,0.260575,178,3399,3577,4,0,12,0,5,1,1,0.375,0.359825,0.5004166666666666,0.260575,178,3399,3577,Working Day
351,2011-12-17,4,0,12,0,6,0,2,0.258333,0.249371,0.560833,0.243167,275,2464,2739,4,0,12,0,6,0,1,0.25833333333333336,0.24937083333333332,0.5608333333333334,0.24316666666666667,275,2464,2739,Weekend
352,2011-12-18,4,0,12,0,0,0,1,0.238333,0.245579,0.58625,0.169779,220,2211,2431,4,0,12,0,0,0,1,0.2383333333333333,0.24557916666666668,0.58625,0.16977916666666668,220,2211,2431,Weekend
353,2011-12-19,4,0,12,0,1,1,1,0.276667,0.280933,0.6375,0.172896,260,3143,3403,4,0,12,0,1,1,1,0.27666666666666667,0.2809333333333333,0.6375000000000001,0.17289583333333333,260,3143,3403,Working Day
354,2011-12-20,4,0,12,0,2,1,2,0.385833,0.396454,0.595417,0.0615708,216,3534,3750,4,0,12,0,2,1,1,0.3858333333333333,0.3964541666666667,0.5954166666666667,0.06157083333333333,216,3534,3750,Working Day
355,2011-12-21,1,0,12,0,3,1,2,0.428333,0.428017,0.858333,0.2214,107,2553,2660,1,0,12,0,3,1,2,0.4283333333333333,0.4280166666666667,0.8583333333333334,0.2214,107,2553,2660,Working Day
356,2011-12-22,1,0,12,0,4,1,2,0.423333,0.426121,0.7575,0.047275,227,2841,3068,1,0,12,0,4,1,2,0.42333333333333334,0.42612083333333334,0.7575,0.047275000000000005,227,2841,3068,Working Day
357,2011-12-23,1,0,12,0,5,1,1,0.373333,0.377513,0.68625,0.274246,163,2046,2209,1,0,12,0,5,1,3,0.37333333333333335,0.3775125,0.6862499999999999,0.27424583333333336,163,2046,2209,Working Day
358,2011-12-24,1,0,12,0,6,0,1,0.3025,0.299242,0.5425,0.190304,155,856,1011,1,0,12,0,6,0,2,0.3025,0.2992416666666667,0.5425,0.1903041666666667,155,856,1011,Weekend
359,2011-12-25,1,0,12,0,0,0,1,0.274783,0.279961,0.681304,0.155091,303,451,754,1,0,12,0,0,0,1,0.2747826086956522,0.2799608695652174,0.681304347826087,0.1550913043478261,303,451,754,Weekend
360,2011-12-26,1,0,12,1,1,0,1,0.321739,0.315535,0.506957,0.239465,430,887,1317,1,0,12,1,1,0,1,0.32173913043478264,0.31553478260869566,0.5069565217391304,0.23946521739130433,430,887,1317,Holiday
361,2011-12-27,1,0,12,0,2,1,2,0.325,0.327633,0.7625,0.18845,103,1059,1162,1,0,12,0,2,1,1,0.325,0.32763333333333333,0.7625000000000001,0.18845,103,1059,1162,Working Day
362,2011-12-28,1,0,12,0,3,1,1,0.29913,0.279974,0.503913,0.293961,255,2047,2302,1,0,12,0,3,1,1,0.2991304347826087,0.27997391304347824,0.5039130434782608,0.2939608695652174,255,2047,2302,Working Day
363,2011-12-29,1,0,12,0,4,1,1,0.248333,0.263892,0.574167,0.119412,254,2169,2423,1,0,12,0,4,1,2,0.24833333333333332,0.2638916666666667,0.5741666666666667,0.11941249999999999,254,2169,2423,Working Day
364,2011-12-30,1,0,12,0,5,1,1,0.311667,0.318812,0.636667,0.134337,491,2508,2999,1,0,12,0,5,1,1,0.3116666666666667,0.3188125,0.6366666666666666,0.1343375,491,2508,2999,Working Day
365,2011-12-31,1,0,12,0,6,0,1,0.41,0.414121,0.615833,0.220154,665,1820,2485,1,0,12,0,6,0,2,0.41,0.4141208333333333,0.6158333333333333,0.22015416666666665,665,1820,2485,Weekend
366,2012-01-01,1,1,1,0,0,0,1,0.37,0.375621,0.6925,0.192167,686,1608,2294,1,1,1,0,0,0,1,0.37000000000000005,0.37562083333333335,0.6925,0.19216666666666668,686,1608,2294,Weekend
367,2012-01-02,1,1,1,1,1,0,1,0.273043,0.252304,0.381304,0.329665,244,1707,1951,1,1,1,1,1,0,1,0.27304347826086955,0.25230434782608696,0.38130434782608696,0.32966521739130433,244,1707,1951,Holiday
368,2012-01-03,1,1,1,0,2,1,1,0.15,0.126275,0.44125,0.365671,89,2147,2236,1,1,1,0,2,1,1,0.15,0.126275,0.44125,0.36567083333333333,89,2147,2236,Working Day
369,2012-01-04,1,1,1,0,3,1,2,0.1075,0.119337,0.414583,0.1847,95,2273,2368,1,1,1,0,3,1,1,0.1075,0.1193375,0.4145833333333333,0.1847,95,2273,2368,Working Day
370,2012-01-05,1,1,1,0,4,1,1,0.265833,0.278412,0.524167,0.129987,140,3132,3272,1,1,1,0,4,1,2,0.2658333333333333,0.2784125,0.5241666666666667,0.1299875,140,3132,3272,Working Day
371,2012-01-06,1,1,1,0,5,1,1,0.334167,0.340267,0.542083,0.167908,307,3791,4098,1,1,1,0,5,1,1,0.33416666666666667,0.34026666666666666,0.5420833333333334,0.16790833333333333,307,3791,4098,Working Day
372,2012-01-07,1,1,1,0,6,0,1,0.393333,0.390779,0.531667,0.174758,1070,3451,4521,1,1,1,0,6,0,1,0.3933333333333333,0.3907791666666667,0.5316666666666666,0.17475833333333335,1070,3451,4521,Weekend
373,2012-01-08,1,1,1,0,0,0,1,0.3375,0.340258,0.465,0.191542,599,2826,3425,1,1,1,0,0,0,1,0.33749999999999997,0.34025833333333333,0.465,0.19154166666666664,599,2826,3425,Weekend
374,2012-01-09,1,1,1,0,1,1,2,0.224167,0.247479,0.701667,0.0989,106,2270,2376,1,1,1,0,1,1,1,0.22416666666666665,0.24747916666666667,0.7016666666666667,0.0989,106,2270,2376,Working Day
375,2012-01-10,1,1,1,0,2,1,1,0.308696,0.318826,0.646522,0.187552,173,3425,3598,1,1,1,0,2,1,2,0.30869565217391304,0.31882608695652176,0.6465217391304349,0.18755217391304346,173,3425,3598,Working Day
376,2012-01-11,1,1,1,0,3,1,2,0.274167,0.282821,0.8475,0.131221,92,2085,2177,1,1,1,0,3,1,1,0.27416666666666667,0.28282083333333335,0.8475,0.13122083333333334,92,2085,2177,Working Day
377,2012-01-12,1,1,1,0,4,1,2,0.3825,0.381938,0.802917,0.180967,269,3828,4097,1,1,1,0,4,1,3,0.3825,0.3819375,0.8029166666666666,0.1809666666666667,269,3828,4097,Working Day
378,2012-01-13,1,1,1,0,5,1,1,0.274167,0.249362,0.5075,0.378108,174,3040,3214,1,1,1,0,5,1,2,0.27416666666666667,0.24936250000000001,0.5075,0.3781083333333333,174,3040,3214,Working Day
379,2012-01-14,1,1,1,0,6,0,1,0.18,0.183087,0.4575,0.187183,333,2160,2493,1,1,1,0,6,0,1,0.18000000000000002,0.1830875,0.4575,0.18718333333333334,333,2160,2493,Weekend
380,2012-01-15,1,1,1,0,0,0,1,0.166667,0.161625,0.419167,0.251258,284,2027,2311,1,1,1,0,0,0,1,0.16666666666666666,0.161625,0.4191666666666667,0.2512583333333333,284,2027,2311,Weekend
381,2012-01-16,1,1,1,1,1,0,1,0.19,0.190663,0.5225,0.231358,217,2081,2298,1,1,1,1,1,0,1,0.19000000000000003,0.19066249999999998,0.5225,0.23135833333333333,217,2081,2298,Holiday
382,2012-01-17,1,1,1,0,2,1,2,0.373043,0.364278,0.716087,0.34913,127,2808,2935,1,1,1,0,2,1,2,0.3730434782608696,0.36427826086956516,0.716086956521739,0.3491304347826087,127,2808,2935,Working Day
383,2012-01-18,1,1,1,0,3,1,1,0.303333,0.275254,0.443333,0.415429,109,3267,3376,1,1,1,0,3,1,2,0.30333333333333334,0.27525416666666663,0.44333333333333336,0.4154291666666667,109,3267,3376,Working Day
384,2012-01-19,1,1,1,0,4,1,1,0.19,0.190038,0.4975,0.220158,130,3162,3292,1,1,1,0,4,1,1,0.19000000000000003,0.1900375,0.4975,0.22015833333333334,130,3162,3292,Working Day
385,2012-01-20,1,1,1,0,5,1,2,0.2175,0.220958,0.45,0.20275,115,3048,3163,1,1,1,0,5,1,2,0.2175,0.22095833333333334,0.45,0.20274999999999999,115,3048,3163,Working Day
386,2012-01-21,1,1,1,0,6,0,2,0.173333,0.174875,0.83125,0.222642,67,1234,1301,1,1,1,0,6,0,3,0.17333333333333334,0.174875,0.8312499999999999,0.22264166666666665,67,1234,1301,Weekend
387,2012-01-22,1,1,1,0,0,0,2,0.1625,0.16225,0.79625,0.199638,196,1781,1977,1,1,1,0,0,0,1,0.1625,0.16224999999999998,0.79625,0.1996375,196,1781,1977,Weekend
388,2012-01-23,1,1,1,0,1,1,2,0.218333,0.243058,0.91125,0.110708,145,2287,2432,1,1,1,0,1,1,2,0.21833333333333335,0.24305833333333335,0.91125,0.11070833333333334,145,2287,2432,Working Day
389,2012-01-24,1,1,1,0,2,1,1,0.3425,0.349108,0.835833,0.123767,439,3900,4339,1,1,1,0,2,1,2,0.3425,0.34910833333333335,0.8358333333333333,0.12376666666666668,439,3900,4339,Working Day
390,2012-01-25,1,1,1,0,3,1,1,0.294167,0.294821,0.64375,0.161071,467,3803,4270,1,1,1,0,3,1,1,0.2941666666666667,0.2948208333333333,0.6437499999999999,0.16107083333333333,467,3803,4270,Working Day
391,2012-01-26,1,1,1,0,4,1,2,0.341667,0.35605,0.769583,0.0733958,244,3831,4075,1,1,1,0,4,1,2,0.34166666666666673,0.35605,0.7695833333333333,0.07339583333333334,244,3831,4075,Working Day
392,2012-01-27,1,1,1,0,5,1,2,0.425,0.415383,0.74125,0.342667,269,3187,3456,1,1,1,0,5,1,2,0.425,0.4153833333333334,0.74125,0.3426666666666667,269,3187,3456,Working Day
393,2012-01-28,1,1,1,0,6,0,1,0.315833,0.326379,0.543333,0.210829,775,3248,4023,1,1,1,0,6,0,1,0.31583333333333335,0.32637916666666666,0.5433333333333333,0.21082916666666665,775,3248,4023,Weekend
394,2012-01-29,1,1,1,0,0,0,1,0.2825,0.272721,0.31125,0.24005,558,2685,3243,1,1,1,0,0,0,1,0.28250000000000003,0.27272083333333336,0.31125,0.24004999999999999,558,2685,3243,Weekend
395,2012-01-30,1,1,1,0,1,1,1,0.269167,0.262625,0.400833,0.215792,126,3498,3624,1,1,1,0,1,1,2,0.26916666666666667,0.262625,0.4008333333333333,0.2157916666666667,126,3498,3624,Working Day
396,2012-01-31,1,1,1,0,2,1,1,0.39,0.381317,0.416667,0.261817,324,4185,4509,1,1,1,0,2,1,1,0.38999999999999996,0.3813166666666667,0.4166666666666667,0.26181666666666664,324,4185,4509,Working Day
397,2012-02-01,1,1,2,0,3,1,1,0.469167,0.466538,0.507917,0.189067,304,4275,4579,1,1,2,0,3,1,1,0.4691666666666667,0.4665375,0.5079166666666667,0.1890666666666667,304,4275,4579,Working Day
398,2012-02-02,1,1,2,0,4,1,2,0.399167,0.398971,0.672917,0.187187,190,3571,3761,1,1,2,0,4,1,1,0.39916666666666667,0.39897083333333333,0.6729166666666666,0.18718749999999998,190,3571,3761,Working Day
399,2012-02-03,1,1,2,0,5,1,1,0.313333,0.309346,0.526667,0.178496,310,3841,4151,1,1,2,0,5,1,1,0.31333333333333335,0.3093458333333333,0.5266666666666667,0.17849583333333333,310,3841,4151,Working Day
400,2012-02-04,1,1,2,0,6,0,2,0.264167,0.272725,0.779583,0.121896,384,2448,2832,1,1,2,0,6,0,1,0.26416666666666666,0.272725,0.7795833333333334,0.12189583333333333,384,2448,2832,Weekend
401,2012-02-05,1,1,2,0,0,0,2,0.265833,0.264521,0.687917,0.175996,318,2629,2947,1,1,2,0,0,0,2,0.2658333333333333,0.2645208333333333,0.6879166666666667,0.17599583333333335,318,2629,2947,Weekend
402,2012-02-06,1,1,2,0,1,1,1,0.282609,0.296426,0.622174,0.1538,206,3578,3784,1,1,2,0,1,1,1,0.2826086956521739,0.29642608695652173,0.6221739130434782,0.1538,206,3578,3784,Working Day
403,2012-02-07,1,1,2,0,2,1,1,0.354167,0.361104,0.49625,0.147379,199,4176,4375,1,1,2,0,2,1,1,0.3541666666666667,0.3611041666666666,0.49625,0.14737916666666667,199,4176,4375,Working Day
404,2012-02-08,1,1,2,0,3,1,2,0.256667,0.266421,0.722917,0.133721,109,2693,2802,1,1,2,0,3,1,1,0.25666666666666665,0.26642083333333333,0.7229166666666668,0.13372083333333332,109,2693,2802,Working Day
405,2012-02-09,1,1,2,0,4,1,1,0.265,0.261988,0.562083,0.194037,163,3667,3830,1,1,2,0,4,1,2,0.265,0.2619875,0.5620833333333334,0.1940375,163,3667,3830,Working Day
406,2012-02-10,1,1,2,0,5,1,2,0.280833,0.293558,0.54,0.116929,227,3604,3831,1,1,2,0,5,1,2,0.2808333333333333,0.2935583333333333,0.54,0.11692916666666668,227,3604,3831,Working Day
407,2012-02-11,1,1,2,0,6,0,3,0.224167,0.210867,0.73125,0.289796,192,1977,2169,1,1,2,0,6,0,2,0.22416666666666665,0.21086666666666667,0.7312500000000001,0.2897958333333333,192,1977,2169,Weekend
408,2012-02-12,1,1,2,0,0,0,1,0.1275,0.101658,0.464583,0.409212,73,1456,1529,1,1,2,0,0,0,3,0.1275,0.10165833333333334,0.46458333333333335,0.4092125,73,1456,1529,Weekend
409,2012-02-13,1,1,2,0,1,1,1,0.2225,0.227913,0.41125,0.167283,94,3328,3422,1,1,2,0,1,1,1,0.2225,0.2279125,0.41125000000000006,0.16728333333333334,94,3328,3422,Working Day
410,2012-02-14,1,1,2,0,2,1,2,0.319167,0.333946,0.50875,0.141179,135,3787,3922,1,1,2,0,2,1,2,0.31916666666666665,0.33394583333333333,0.50875,0.14117916666666666,135,3787,3922,Working Day
411,2012-02-15,1,1,2,0,3,1,1,0.348333,0.351629,0.53125,0.1816,141,4028,4169,1,1,2,0,3,1,1,0.34833333333333333,0.35162916666666666,0.53125,0.1816,141,4028,4169,Working Day
412,2012-02-16,1,1,2,0,4,1,2,0.316667,0.330162,0.752917,0.091425,74,2931,3005,1,1,2,0,4,1,2,0.31666666666666665,0.33016249999999997,0.7529166666666667,0.09142499999999999,74,2931,3005,Working Day
413,2012-02-17,1,1,2,0,5,1,1,0.343333,0.351629,0.634583,0.205846,349,3805,4154,1,1,2,0,5,1,2,0.3433333333333333,0.35162916666666666,0.6345833333333334,0.2058458333333333,349,3805,4154,Working Day
414,2012-02-18,1,1,2,0,6,0,1,0.346667,0.355425,0.534583,0.190929,1435,2883,4318,1,1,2,0,6,0,1,0.3466666666666667,0.35542500000000005,0.5345833333333333,0.19092916666666668,1435,2883,4318,Weekend
415,2012-02-19,1,1,2,0,0,0,2,0.28,0.265788,0.515833,0.253112,618,2071,2689,1,1,2,0,0,0,2,0.27999999999999997,0.2657875,0.5158333333333334,0.2531125,618,2071,2689,Weekend
416,2012-02-20,1,1,2,1,1,0,1,0.28,0.273391,0.507826,0.229083,502,2627,3129,1,1,2,1,1,0,2,0.28,0.2733913043478261,0.5078260869565218,0.2290826086956522,502,2627,3129,Holiday
417,2012-02-21,1,1,2,0,2,1,1,0.287826,0.295113,0.594348,0.205717,163,3614,3777,1,1,2,0,2,1,1,0.28782608695652173,0.29511304347826084,0.5943478260869565,0.2057173913043478,163,3614,3777,Working Day
418,2012-02-22,1,1,2,0,3,1,1,0.395833,0.392667,0.567917,0.234471,394,4379,4773,1,1,2,0,3,1,1,0.3958333333333333,0.39266666666666666,0.5679166666666666,0.23447083333333332,394,4379,4773,Working Day
419,2012-02-23,1,1,2,0,4,1,1,0.454167,0.444446,0.554583,0.190913,516,4546,5062,1,1,2,0,4,1,2,0.45416666666666666,0.4444458333333334,0.5545833333333333,0.1909125,516,4546,5062,Working Day
420,2012-02-24,1,1,2,0,5,1,2,0.4075,0.410971,0.7375,0.237567,246,3241,3487,1,1,2,0,5,1,2,0.4075,0.41097083333333334,0.7374999999999999,0.23756666666666668,246,3241,3487,Working Day
421,2012-02-25,1,1,2,0,6,0,1,0.290833,0.255675,0.395833,0.421642,317,2415,2732,1,1,2,0,6,0,1,0.29083333333333333,0.255675,0.3958333333333333,0.4216416666666667,317,2415,2732,Weekend
422,2012-02-26,1,1,2,0,0,0,1,0.279167,0.268308,0.41,0.205229,515,2874,3389,1,1,2,0,0,0,1,0.2791666666666667,0.2683083333333333,0.41,0.20522916666666668,515,2874,3389,Weekend
423,2012-02-27,1,1,2,0,1,1,1,0.366667,0.357954,0.490833,0.268033,253,4069,4322,1,1,2,0,1,1,1,0.3666666666666667,0.35795416666666663,0.4908333333333333,0.26803333333333335,253,4069,4322,Working Day
424,2012-02-28,1,1,2,0,2,1,1,0.359167,0.353525,0.395833,0.193417,229,4134,4363,1,1,2,0,2,1,1,0.3591666666666667,0.35352500000000003,0.3958333333333333,0.19341666666666668,229,4134,4363,Working Day
425,2012-02-29,1,1,2,0,3,1,2,0.344348,0.34847,0.804783,0.179117,65,1769,1834,1,1,2,0,3,1,1,0.3443478260869565,0.34846956521739125,0.8047826086956522,0.1791173913043478,65,1769,1834,Working Day
426,2012-03-01,1,1,3,0,4,1,1,0.485833,0.475371,0.615417,0.226987,325,4665,4990,1,1,3,0,4,1,2,0.48583333333333334,0.4753708333333333,0.6154166666666666,0.2269875,325,4665,4990,Working Day
427,2012-03-02,1,1,3,0,5,1,2,0.353333,0.359842,0.657083,0.144904,246,2948,3194,1,1,3,0,5,1,1,0.35333333333333333,0.35984166666666667,0.6570833333333334,0.14490416666666667,246,2948,3194,Working Day
428,2012-03-03,1,1,3,0,6,0,2,0.414167,0.413492,0.62125,0.161079,956,3110,4066,1,1,3,0,6,0,3,0.4141666666666666,0.41349166666666665,0.62125,0.16107916666666666,956,3110,4066,Weekend
429,2012-03-04,1,1,3,0,0,0,1,0.325833,0.303021,0.403333,0.334571,710,2713,3423,1,1,3,0,0,0,2,0.32583333333333336,0.30302083333333335,0.4033333333333333,0.3345708333333333,710,2713,3423,Weekend
430,2012-03-05,1,1,3,0,1,1,1,0.243333,0.241171,0.50625,0.228858,203,3130,3333,1,1,3,0,1,1,1,0.24333333333333332,0.24117083333333333,0.50625,0.2288583333333333,203,3130,3333,Working Day
431,2012-03-06,1,1,3,0,2,1,1,0.258333,0.255042,0.456667,0.200875,221,3735,3956,1,1,3,0,2,1,1,0.25833333333333336,0.25504166666666667,0.4566666666666667,0.200875,221,3735,3956,Working Day
432,2012-03-07,1,1,3,0,3,1,1,0.404167,0.3851,0.513333,0.345779,432,4484,4916,1,1,3,0,3,1,1,0.40416666666666673,0.3851,0.5133333333333333,0.3457791666666667,432,4484,4916,Working Day
433,2012-03-08,1,1,3,0,4,1,1,0.5275,0.524604,0.5675,0.441563,486,4896,5382,1,1,3,0,4,1,1,0.5275,0.5246041666666666,0.5675,0.4415625,486,4896,5382,Working Day
434,2012-03-09,1,1,3,0,5,1,2,0.410833,0.397083,0.407083,0.4148,447,4122,4569,1,1,3,0,5,1,2,0.41083333333333333,0.3970833333333333,0.4070833333333333,0.4148,447,4122,4569,Working Day
435,2012-03-10,1,1,3,0,6,0,1,0.2875,0.277767,0.350417,0.22575,968,3150,4118,1,1,3,0,6,0,1,0.28750000000000003,0.27776666666666666,0.35041666666666665,0.22575,968,3150,4118,Weekend
436,2012-03-11,1,1,3,0,0,0,1,0.361739,0.35967,0.476957,0.222587,1658,3253,4911,1,1,3,0,0,0,1,0.3617391304347826,0.3596695652173913,0.4769565217391304,0.22258695652173915,1658,3253,4911,Weekend
437,2012-03-12,1,1,3,0,1,1,1,0.466667,0.459592,0.489167,0.207713,838,4460,5298,1,1,3,0,1,1,1,0.46666666666666673,0.4595916666666666,0.4891666666666667,0.2077125,838,4460,5298,Working Day
438,2012-03-13,1,1,3,0,2,1,1,0.565,0.542929,0.6175,0.23695,762,5085,5847,1,1,3,0,2,1,2,0.5650000000000001,0.5429291666666667,0.6175,0.23695,762,5085,5847,Working Day
439,2012-03-14,1,1,3,0,3,1,1,0.5725,0.548617,0.507083,0.115062,997,5315,6312,1,1,3,0,3,1,1,0.5725,0.5486166666666666,0.5070833333333333,0.1150625,997,5315,6312,Working Day
440,2012-03-15,1,1,3,0,4,1,1,0.5575,0.532825,0.579583,0.149883,1005,5187,6192,1,1,3,0,4,1,1,0.5575,0.532825,0.5795833333333333,0.14988333333333334,1005,5187,6192,Working Day
441,2012-03-16,1,1,3,0,5,1,2,0.435833,0.436229,0.842083,0.113192,548,3830,4378,1,1,3,0,5,1,1,0.43583333333333335,0.43622916666666667,0.8420833333333334,0.11319166666666668,548,3830,4378,Working Day
442,2012-03-17,1,1,3,0,6,0,2,0.514167,0.505046,0.755833,0.110704,3155,4681,7836,1,1,3,0,6,0,2,0.5141666666666667,0.5050458333333333,0.7558333333333334,0.11070416666666667,3155,4681,7836,Weekend
443,2012-03-18,1,1,3,0,0,0,2,0.4725,0.464,0.81,0.126883,2207,3685,5892,1,1,3,0,0,0,1,0.4725,0.464,0.81,0.12688333333333332,2207,3685,5892,Weekend
444,2012-03-19,1,1,3,0,1,1,1,0.545,0.532821,0.72875,0.162317,982,5171,6153,1,1,3,0,1,1,1,0.545,0.5328208333333333,0.7287499999999999,0.16231666666666666,982,5171,6153,Working Day
445,2012-03-20,1,1,3,0,2,1,1,0.560833,0.538533,0.807917,0.121271,1051,5042,6093,1,1,3,0,2,1,2,0.5608333333333334,0.5385333333333333,0.8079166666666667,0.12127083333333333,1051,5042,6093,Working Day
446,2012-03-21,2,1,3,0,3,1,2,0.531667,0.513258,0.82125,0.0895583,1122,5108,6230,2,1,3,0,3,1,1,0.5316666666666666,0.5132583333333333,0.82125,0.08955833333333334,1122,5108,6230,Working Day
447,2012-03-22,2,1,3,0,4,1,1,0.554167,0.531567,0.83125,0.117562,1334,5537,6871,2,1,3,0,4,1,1,0.5541666666666667,0.5315666666666666,0.8312499999999999,0.1175625,1334,5537,6871,Working Day
448,2012-03-23,2,1,3,0,5,1,2,0.601667,0.570067,0.694167,0.1163,2469,5893,8362,2,1,3,0,5,1,1,0.6016666666666667,0.5700666666666666,0.6941666666666667,0.1163,2469,5893,8362,Working Day
449,2012-03-24,2,1,3,0,6,0,2,0.5025,0.486733,0.885417,0.192783,1033,2339,3372,2,1,3,0,6,0,1,0.5025000000000001,0.4867333333333333,0.8854166666666666,0.19278333333333333,1033,2339,3372,Weekend
450,2012-03-25,2,1,3,0,0,0,2,0.4375,0.437488,0.880833,0.220775,1532,3464,4996,2,1,3,0,0,0,2,0.4375,0.43748750000000003,0.8808333333333334,0.22077500000000003,1532,3464,4996,Weekend
451,2012-03-26,2,1,3,0,1,1,1,0.445833,0.43875,0.477917,0.386821,795,4763,5558,2,1,3,0,1,1,2,0.4458333333333333,0.43875,0.4779166666666666,0.38682083333333334,795,4763,5558,Working Day
452,2012-03-27,2,1,3,0,2,1,1,0.323333,0.315654,0.29,0.187192,531,4571,5102,2,1,3,0,2,1,1,0.3233333333333333,0.3156541666666667,0.29,0.18719166666666667,531,4571,5102,Working Day
453,2012-03-28,2,1,3,0,3,1,1,0.484167,0.47095,0.48125,0.291671,674,5024,5698,2,1,3,0,3,1,1,0.4841666666666667,0.47095,0.48125,0.2916708333333333,674,5024,5698,Working Day
454,2012-03-29,2,1,3,0,4,1,1,0.494167,0.482304,0.439167,0.31965,834,5299,6133,2,1,3,0,4,1,1,0.49416666666666664,0.4823041666666667,0.43916666666666665,0.31965,834,5299,6133,Working Day
455,2012-03-30,2,1,3,0,5,1,2,0.37,0.375621,0.580833,0.138067,796,4663,5459,2,1,3,0,5,1,1,0.37000000000000005,0.37562083333333335,0.5808333333333333,0.13806666666666667,796,4663,5459,Working Day
456,2012-03-31,2,1,3,0,6,0,2,0.424167,0.421708,0.738333,0.250617,2301,3934,6235,2,1,3,0,6,0,1,0.42416666666666664,0.42170833333333335,0.7383333333333333,0.25061666666666665,2301,3934,6235,Weekend
457,2012-04-01,2,1,4,0,0,0,2,0.425833,0.417287,0.67625,0.172267,2347,3694,6041,2,1,4,0,0,0,2,0.42583333333333334,0.41728750000000003,0.67625,0.17226666666666668,2347,3694,6041,Weekend
458,2012-04-02,2,1,4,0,1,1,1,0.433913,0.427513,0.504348,0.312139,1208,4728,5936,2,1,4,0,1,1,3,0.4339130434782609,0.4275130434782609,0.5043478260869565,0.3121391304347826,1208,4728,5936,Working Day
459,2012-04-03,2,1,4,0,2,1,1,0.466667,0.461483,0.396667,0.100133,1348,5424,6772,2,1,4,0,2,1,1,0.4666666666666666,0.4614833333333333,0.39666666666666667,0.10013333333333334,1348,5424,6772,Working Day
460,2012-04-04,2,1,4,0,3,1,1,0.541667,0.53345,0.469583,0.180975,1058,5378,6436,2,1,4,0,3,1,1,0.5416666666666666,0.53345,0.4695833333333333,0.180975,1058,5378,6436,Working Day
461,2012-04-05,2,1,4,0,4,1,1,0.435,0.431163,0.374167,0.219529,1192,5265,6457,2,1,4,0,4,1,1,0.435,0.43116250000000006,0.3741666666666667,0.21952916666666666,1192,5265,6457,Working Day
462,2012-04-06,2,1,4,0,5,1,1,0.403333,0.390767,0.377083,0.300388,1807,4653,6460,2,1,4,0,5,1,1,0.4033333333333333,0.39076666666666665,0.3770833333333334,0.3003875,1807,4653,6460,Working Day
463,2012-04-07,2,1,4,0,6,0,1,0.4375,0.426129,0.254167,0.274871,3252,3605,6857,2,1,4,0,6,0,1,0.4375,0.42612916666666667,0.2541666666666667,0.27487083333333334,3252,3605,6857,Weekend
464,2012-04-08,2,1,4,0,0,0,1,0.5,0.492425,0.275833,0.232596,2230,2939,5169,2,1,4,0,0,0,1,0.5,0.49242499999999995,0.2758333333333333,0.23259583333333333,2230,2939,5169,Weekend
465,2012-04-09,2,1,4,0,1,1,1,0.489167,0.476638,0.3175,0.358196,905,4680,5585,2,1,4,0,1,1,1,0.4891666666666667,0.4766375,0.3175,0.3581958333333333,905,4680,5585,Working Day
466,2012-04-10,2,1,4,0,2,1,1,0.446667,0.436233,0.435,0.249375,819,5099,5918,2,1,4,0,2,1,2,0.4466666666666667,0.4362333333333333,0.435,0.249375,819,5099,5918,Working Day
467,2012-04-11,2,1,4,0,3,1,1,0.348696,0.337274,0.469565,0.295274,482,4380,4862,2,1,4,0,3,1,1,0.348695652173913,0.33727391304347826,0.46956521739130436,0.2952739130434782,482,4380,4862,Working Day
468,2012-04-12,2,1,4,0,4,1,1,0.3975,0.387604,0.46625,0.290429,663,4746,5409,2,1,4,0,4,1,1,0.39749999999999996,0.3876041666666667,0.46625,0.2904291666666667,663,4746,5409,Working Day
469,2012-04-13,2,1,4,0,5,1,1,0.4425,0.431808,0.408333,0.155471,1252,5146,6398,2,1,4,0,5,1,1,0.44250000000000006,0.43180833333333335,0.4083333333333334,0.15547083333333334,1252,5146,6398,Working Day
470,2012-04-14,2,1,4,0,6,0,1,0.495,0.487996,0.502917,0.190917,2795,4665,7460,2,1,4,0,6,0,1,0.49500000000000005,0.48799583333333335,0.5029166666666667,0.19091666666666665,2795,4665,7460,Weekend
471,2012-04-15,2,1,4,0,0,0,1,0.606667,0.573875,0.507917,0.225129,2846,4286,7132,2,1,4,0,0,0,2,0.6066666666666667,0.573875,0.5079166666666667,0.22512916666666669,2846,4286,7132,Weekend
472,2012-04-16,2,1,4,1,1,0,1,0.664167,0.614925,0.561667,0.284829,1198,5172,6370,2,1,4,1,1,0,1,0.6641666666666667,0.6149249999999999,0.5616666666666666,0.28482916666666663,1198,5172,6370,Holiday
473,2012-04-17,2,1,4,0,2,1,1,0.608333,0.598487,0.390417,0.273629,989,5702,6691,2,1,4,0,2,1,1,0.6083333333333333,0.5984875,0.39041666666666663,0.27362916666666665,989,5702,6691,Working Day
474,2012-04-18,2,1,4,0,3,1,2,0.463333,0.457038,0.569167,0.167912,347,4020,4367,2,1,4,0,3,1,1,0.4633333333333333,0.4570375,0.5691666666666667,0.1679125,347,4020,4367,Working Day
475,2012-04-19,2,1,4,0,4,1,1,0.498333,0.493046,0.6125,0.0659292,846,5719,6565,2,1,4,0,4,1,3,0.49833333333333335,0.49304583333333335,0.6124999999999999,0.06592916666666666,846,5719,6565,Working Day
476,2012-04-20,2,1,4,0,5,1,1,0.526667,0.515775,0.694583,0.149871,1340,5950,7290,2,1,4,0,5,1,1,0.5266666666666667,0.515775,0.6945833333333334,0.14987083333333334,1340,5950,7290,Working Day
477,2012-04-21,2,1,4,0,6,0,1,0.57,0.542921,0.682917,0.283587,2541,4083,6624,2,1,4,0,6,0,1,0.57,0.5429208333333333,0.6829166666666667,0.2835875,2541,4083,6624,Weekend
478,2012-04-22,2,1,4,0,0,0,3,0.396667,0.389504,0.835417,0.344546,120,907,1027,2,1,4,0,0,0,2,0.39666666666666667,0.3895041666666667,0.8354166666666667,0.34454583333333333,120,907,1027,Weekend
479,2012-04-23,2,1,4,0,1,1,2,0.321667,0.301125,0.766667,0.303496,195,3019,3214,2,1,4,0,1,1,3,0.32166666666666666,0.301125,0.7666666666666666,0.30349583333333335,195,3019,3214,Working Day
480,2012-04-24,2,1,4,0,2,1,1,0.413333,0.405283,0.454167,0.249383,518,5115,5633,2,1,4,0,2,1,2,0.41333333333333333,0.4052833333333334,0.45416666666666666,0.24938333333333332,518,5115,5633,Working Day
481,2012-04-25,2,1,4,0,3,1,1,0.476667,0.470317,0.427917,0.118792,655,5541,6196,2,1,4,0,3,1,1,0.4766666666666666,0.47031666666666666,0.42791666666666667,0.11879166666666667,655,5541,6196,Working Day
482,2012-04-26,2,1,4,0,4,1,2,0.498333,0.483583,0.756667,0.176625,475,4551,5026,2,1,4,0,4,1,2,0.49833333333333335,0.4835833333333333,0.7566666666666667,0.176625,475,4551,5026,Working Day
483,2012-04-27,2,1,4,0,5,1,1,0.4575,0.452637,0.400833,0.347633,1014,5219,6233,2,1,4,0,5,1,1,0.4575,0.4526375,0.4008333333333333,0.3476333333333333,1014,5219,6233,Working Day
484,2012-04-28,2,1,4,0,6,0,2,0.376667,0.377504,0.489583,0.129975,1120,3100,4220,2,1,4,0,6,0,1,0.3766666666666667,0.3775041666666667,0.4895833333333333,0.129975,1120,3100,4220,Weekend
485,2012-04-29,2,1,4,0,0,0,1,0.458333,0.450121,0.587083,0.116908,2229,4075,6304,2,1,4,0,0,0,3,0.4583333333333333,0.4501208333333333,0.5870833333333333,0.11690833333333334,2229,4075,6304,Weekend
486,2012-04-30,2,1,4,0,1,1,2,0.464167,0.457696,0.57,0.171638,665,4907,5572,2,1,4,0,1,1,1,0.46416666666666667,0.45769583333333336,0.57,0.1716375,665,4907,5572,Working Day
487,2012-05-01,2,1,5,0,2,1,2,0.613333,0.577021,0.659583,0.156096,653,5087,5740,2,1,5,0,2,1,2,0.6133333333333334,0.5770208333333333,0.6595833333333333,0.15609583333333332,653,5087,5740,Working Day
488,2012-05-02,2,1,5,0,3,1,1,0.564167,0.537896,0.797083,0.138058,667,5502,6169,2,1,5,0,3,1,1,0.5641666666666667,0.5378958333333334,0.7970833333333333,0.1380583333333333,667,5502,6169,Working Day
489,2012-05-03,2,1,5,0,4,1,2,0.56,0.537242,0.768333,0.133696,764,5657,6421,2,1,5,0,4,1,2,0.5599999999999999,0.5372416666666667,0.7683333333333334,0.13369583333333332,764,5657,6421,Working Day
490,2012-05-04,2,1,5,0,5,1,1,0.6275,0.590917,0.735417,0.162938,1069,5227,6296,2,1,5,0,5,1,1,0.6275000000000001,0.5909166666666666,0.7354166666666666,0.1629375,1069,5227,6296,Working Day
491,2012-05-05,2,1,5,0,6,0,2,0.621667,0.584608,0.756667,0.152992,2496,4387,6883,2,1,5,0,6,0,1,0.6216666666666667,0.5846083333333333,0.7566666666666667,0.15299166666666666,2496,4387,6883,Weekend
492,2012-05-06,2,1,5,0,0,0,2,0.5625,0.546737,0.74,0.149879,2135,4224,6359,2,1,5,0,0,0,2,0.5625,0.5467375,0.7399999999999999,0.14987916666666667,2135,4224,6359,Weekend
493,2012-05-07,2,1,5,0,1,1,2,0.5375,0.527142,0.664167,0.230721,1008,5265,6273,2,1,5,0,1,1,2,0.5375,0.5271416666666667,0.6641666666666667,0.23072083333333335,1008,5265,6273,Working Day
494,2012-05-08,2,1,5,0,2,1,2,0.581667,0.557471,0.685833,0.296029,738,4990,5728,2,1,5,0,2,1,2,0.5816666666666667,0.5574708333333332,0.6858333333333334,0.2960291666666667,738,4990,5728,Working Day
495,2012-05-09,2,1,5,0,3,1,2,0.575,0.553025,0.744167,0.216412,620,4097,4717,2,1,5,0,3,1,2,0.5750000000000001,0.553025,0.7441666666666666,0.2164125,620,4097,4717,Working Day
496,2012-05-10,2,1,5,0,4,1,1,0.505833,0.491783,0.552083,0.314063,1026,5546,6572,2,1,5,0,4,1,3,0.5058333333333334,0.4917833333333333,0.5520833333333334,0.31406249999999997,1026,5546,6572,Working Day
497,2012-05-11,2,1,5,0,5,1,1,0.533333,0.520833,0.360417,0.236937,1319,5711,7030,2,1,5,0,5,1,1,0.5333333333333333,0.5208333333333334,0.36041666666666666,0.2369375,1319,5711,7030,Working Day
498,2012-05-12,2,1,5,0,6,0,1,0.564167,0.544817,0.480417,0.123133,2622,4807,7429,2,1,5,0,6,0,1,0.5641666666666667,0.5448166666666666,0.48041666666666666,0.12313333333333333,2622,4807,7429,Weekend
499,2012-05-13,2,1,5,0,0,0,1,0.6125,0.585238,0.57625,0.225117,2172,3946,6118,2,1,5,0,0,0,1,0.6125,0.5852375,0.57625,0.22511666666666666,2172,3946,6118,Weekend
500,2012-05-14,2,1,5,0,1,1,2,0.573333,0.5499,0.789583,0.212692,342,2501,2843,2,1,5,0,1,1,2,0.5733333333333334,0.5498999999999999,0.7895833333333333,0.21269166666666664,342,2501,2843,Working Day
501,2012-05-15,2,1,5,0,2,1,2,0.611667,0.576404,0.794583,0.147392,625,4490,5115,2,1,5,0,2,1,2,0.6116666666666667,0.5764041666666667,0.7945833333333333,0.14739166666666667,625,4490,5115,Working Day
502,2012-05-16,2,1,5,0,3,1,1,0.636667,0.595975,0.697917,0.122512,991,6433,7424,2,1,5,0,3,1,2,0.6366666666666666,0.595975,0.6979166666666666,0.12251250000000001,991,6433,7424,Working Day
503,2012-05-17,2,1,5,0,4,1,1,0.593333,0.572613,0.52,0.229475,1242,6142,7384,2,1,5,0,4,1,1,0.5933333333333334,0.5726125,0.52,0.229475,1242,6142,7384,Working Day
504,2012-05-18,2,1,5,0,5,1,1,0.564167,0.551121,0.523333,0.136817,1521,6118,7639,2,1,5,0,5,1,1,0.5641666666666667,0.5511208333333334,0.5233333333333333,0.13681666666666667,1521,6118,7639,Working Day
505,2012-05-19,2,1,5,0,6,0,1,0.6,0.566908,0.45625,0.083975,3410,4884,8294,2,1,5,0,6,0,1,0.6,0.5669083333333333,0.45625,0.08397500000000001,3410,4884,8294,Weekend
506,2012-05-20,2,1,5,0,0,0,1,0.620833,0.583967,0.530417,0.254367,2704,4425,7129,2,1,5,0,0,0,1,0.6208333333333333,0.5839666666666666,0.5304166666666666,0.2543666666666667,2704,4425,7129,Weekend
507,2012-05-21,2,1,5,0,1,1,2,0.598333,0.565667,0.81125,0.233204,630,3729,4359,2,1,5,0,1,1,3,0.5983333333333333,0.5656666666666667,0.8112499999999999,0.23320416666666666,630,3729,4359,Working Day
508,2012-05-22,2,1,5,0,2,1,2,0.615,0.580825,0.765833,0.118167,819,5254,6073,2,1,5,0,2,1,1,0.615,0.580825,0.7658333333333333,0.11816666666666666,819,5254,6073,Working Day
509,2012-05-23,2,1,5,0,3,1,2,0.621667,0.584612,0.774583,0.102,766,4494,5260,2,1,5,0,3,1,1,0.6216666666666667,0.5846125,0.7745833333333333,0.102,766,4494,5260,Working Day
510,2012-05-24,2,1,5,0,4,1,1,0.655,0.6067,0.716667,0.172896,1059,5711,6770,2,1,5,0,4,1,1,0.6549999999999999,0.6066999999999999,0.7166666666666667,0.17289583333333333,1059,5711,6770,Working Day
511,2012-05-25,2,1,5,0,5,1,1,0.68,0.627529,0.747083,0.14055,1417,5317,6734,2,1,5,0,5,1,1,0.68,0.6275291666666666,0.7470833333333333,0.14054999999999998,1417,5317,6734,Working Day
512,2012-05-26,2,1,5,0,6,0,1,0.6925,0.642696,0.7325,0.198992,2855,3681,6536,2,1,5,0,6,0,1,0.6925,0.6426958333333334,0.7325,0.19899166666666668,2855,3681,6536,Weekend
513,2012-05-27,2,1,5,0,0,0,1,0.69,0.641425,0.697083,0.215171,3283,3308,6591,2,1,5,0,0,0,2,0.69,0.641425,0.6970833333333334,0.21517083333333334,3283,3308,6591,Weekend
514,2012-05-28,2,1,5,1,1,0,1,0.7125,0.6793,0.67625,0.196521,2557,3486,6043,2,1,5,1,1,0,1,0.7125,0.6793,0.67625,0.19652083333333334,2557,3486,6043,Holiday
515,2012-05-29,2,1,5,0,2,1,1,0.7225,0.672992,0.684583,0.2954,880,4863,5743,2,1,5,0,2,1,1,0.7225,0.6729916666666668,0.6845833333333333,0.2954,880,4863,5743,Working Day
516,2012-05-30,2,1,5,0,3,1,2,0.656667,0.611129,0.67,0.134329,745,6110,6855,2,1,5,0,3,1,3,0.6566666666666666,0.6111291666666666,0.6699999999999999,0.13432916666666667,745,6110,6855,Working Day
517,2012-05-31,2,1,5,0,4,1,1,0.68,0.631329,0.492917,0.195279,1100,6238,7338,2,1,5,0,4,1,1,0.68,0.6313291666666666,0.49291666666666667,0.19527916666666667,1100,6238,7338,Working Day
518,2012-06-01,2,1,6,0,5,1,2,0.654167,0.607962,0.755417,0.237563,533,3594,4127,2,1,6,0,5,1,1,0.6541666666666667,0.6079625,0.7554166666666666,0.2375625,533,3594,4127,Working Day
519,2012-06-02,2,1,6,0,6,0,1,0.583333,0.566288,0.549167,0.186562,2795,5325,8120,2,1,6,0,6,0,2,0.5833333333333334,0.5662874999999999,0.5491666666666667,0.1865625,2795,5325,8120,Weekend
520,2012-06-03,2,1,6,0,0,0,1,0.6025,0.575133,0.493333,0.184087,2494,5147,7641,2,1,6,0,0,0,1,0.6025,0.5751333333333334,0.49333333333333335,0.1840875,2494,5147,7641,Weekend
521,2012-06-04,2,1,6,0,1,1,1,0.5975,0.578283,0.487083,0.284833,1071,5927,6998,2,1,6,0,1,1,1,0.5975,0.5782833333333334,0.4870833333333333,0.2848333333333333,1071,5927,6998,Working Day
522,2012-06-05,2,1,6,0,2,1,2,0.540833,0.525892,0.613333,0.209575,968,6033,7001,2,1,6,0,2,1,1,0.5408333333333334,0.5258916666666666,0.6133333333333334,0.20957499999999998,968,6033,7001,Working Day
523,2012-06-06,2,1,6,0,3,1,1,0.554167,0.542292,0.61125,0.077125,1027,6028,7055,2,1,6,0,3,1,1,0.5541666666666667,0.5422916666666667,0.61125,0.077125,1027,6028,7055,Working Day
524,2012-06-07,2,1,6,0,4,1,1,0.6025,0.569442,0.567083,0.15735,1038,6456,7494,2,1,6,0,4,1,1,0.6024999999999999,0.5694416666666666,0.5670833333333333,0.15735000000000002,1038,6456,7494,Working Day
525,2012-06-08,2,1,6,0,5,1,1,0.649167,0.597862,0.467917,0.175383,1488,6248,7736,2,1,6,0,5,1,1,0.6491666666666667,0.5978625,0.4679166666666667,0.17538333333333334,1488,6248,7736,Working Day
526,2012-06-09,2,1,6,0,6,0,1,0.710833,0.648367,0.437083,0.144287,2708,4790,7498,2,1,6,0,6,0,1,0.7108333333333333,0.6483666666666666,0.4370833333333333,0.14428749999999999,2708,4790,7498,Weekend
527,2012-06-10,2,1,6,0,0,0,1,0.726667,0.663517,0.538333,0.133721,2224,4374,6598,2,1,6,0,0,0,1,0.7266666666666667,0.6635166666666666,0.5383333333333333,0.13372083333333332,2224,4374,6598,Weekend
528,2012-06-11,2,1,6,0,1,1,2,0.720833,0.659721,0.587917,0.207713,1017,5647,6664,2,1,6,0,1,1,1,0.7208333333333333,0.6597208333333333,0.5879166666666666,0.2077125,1017,5647,6664,Working Day
529,2012-06-12,2,1,6,0,2,1,2,0.653333,0.597875,0.833333,0.214546,477,4495,4972,2,1,6,0,2,1,2,0.6533333333333333,0.597875,0.8333333333333334,0.21454583333333332,477,4495,4972,Working Day
530,2012-06-13,2,1,6,0,3,1,1,0.655833,0.611117,0.582083,0.343279,1173,6248,7421,2,1,6,0,3,1,2,0.6558333333333334,0.6111166666666666,0.5820833333333333,0.34327916666666664,1173,6248,7421,Working Day
531,2012-06-14,2,1,6,0,4,1,1,0.648333,0.624383,0.569583,0.253733,1180,6183,7363,2,1,6,0,4,1,1,0.6483333333333333,0.6243833333333333,0.5695833333333333,0.2537333333333333,1180,6183,7363,Working Day
532,2012-06-15,2,1,6,0,5,1,1,0.639167,0.599754,0.589583,0.176617,1563,6102,7665,2,1,6,0,5,1,1,0.6391666666666667,0.5997541666666667,0.5895833333333333,0.17661666666666667,1563,6102,7665,Working Day
533,2012-06-16,2,1,6,0,6,0,1,0.631667,0.594708,0.504167,0.166667,2963,4739,7702,2,1,6,0,6,0,1,0.6316666666666667,0.5947083333333333,0.5041666666666667,0.16666666666666666,2963,4739,7702,Weekend
534,2012-06-17,2,1,6,0,0,0,1,0.5925,0.571975,0.59875,0.144904,2634,4344,6978,2,1,6,0,0,0,1,0.5925,0.571975,0.59875,0.14490416666666667,2634,4344,6978,Weekend
535,2012-06-18,2,1,6,0,1,1,2,0.568333,0.544842,0.777917,0.174746,653,4446,5099,2,1,6,0,1,1,1,0.5683333333333334,0.5448416666666667,0.7779166666666666,0.17474583333333335,653,4446,5099,Working Day
536,2012-06-19,2,1,6,0,2,1,1,0.688333,0.654692,0.69,0.148017,968,5857,6825,2,1,6,0,2,1,2,0.6883333333333334,0.6546916666666667,0.69,0.14801666666666666,968,5857,6825,Working Day
537,2012-06-20,2,1,6,0,3,1,1,0.7825,0.720975,0.592083,0.113812,872,5339,6211,2,1,6,0,3,1,1,0.7825000000000001,0.720975,0.5920833333333334,0.1138125,872,5339,6211,Working Day
538,2012-06-21,3,1,6,0,4,1,1,0.805833,0.752542,0.567917,0.118787,778,5127,5905,3,1,6,0,4,1,1,0.8058333333333333,0.7525416666666667,0.5679166666666666,0.1187875,778,5127,5905,Working Day
539,2012-06-22,3,1,6,0,5,1,1,0.7775,0.724121,0.57375,0.182842,964,4859,5823,3,1,6,0,5,1,2,0.7775,0.7241208333333332,0.57375,0.18284166666666668,964,4859,5823,Working Day
540,2012-06-23,3,1,6,0,6,0,1,0.731667,0.652792,0.534583,0.179721,2657,4801,7458,3,1,6,0,6,0,1,0.7316666666666666,0.6527916666666667,0.5345833333333333,0.17972083333333333,2657,4801,7458,Weekend
541,2012-06-24,3,1,6,0,0,0,1,0.743333,0.674254,0.479167,0.145525,2551,4340,6891,3,1,6,0,0,0,1,0.7433333333333333,0.6742541666666666,0.4791666666666667,0.145525,2551,4340,6891,Weekend
542,2012-06-25,3,1,6,0,1,1,1,0.715833,0.654042,0.504167,0.300383,1139,5640,6779,3,1,6,0,1,1,1,0.7158333333333333,0.6540416666666666,0.5041666666666667,0.30038333333333334,1139,5640,6779,Working Day
543,2012-06-26,3,1,6,0,2,1,1,0.630833,0.594704,0.373333,0.347642,1077,6365,7442,3,1,6,0,2,1,1,0.6308333333333334,0.5947041666666667,0.37333333333333335,0.3476416666666667,1077,6365,7442,Working Day
544,2012-06-27,3,1,6,0,3,1,1,0.6975,0.640792,0.36,0.271775,1077,6258,7335,3,1,6,0,3,1,1,0.6974999999999999,0.6407916666666666,0.36000000000000004,0.27177500000000004,1077,6258,7335,Working Day
545,2012-06-28,3,1,6,0,4,1,1,0.749167,0.675512,0.4225,0.17165,921,5958,6879,3,1,6,0,4,1,1,0.7491666666666666,0.6755125,0.42250000000000004,0.17165,921,5958,6879,Working Day
546,2012-06-29,3,1,6,0,5,1,1,0.834167,0.786613,0.48875,0.165417,829,4634,5463,3,1,6,0,5,1,1,0.8341666666666666,0.7866124999999999,0.48875,0.16541666666666668,829,4634,5463,Working Day
547,2012-06-30,3,1,6,0,6,0,1,0.765,0.687508,0.60125,0.161071,1455,4232,5687,3,1,6,0,6,0,3,0.765,0.6875083333333333,0.60125,0.16107083333333333,1455,4232,5687,Weekend
548,2012-07-01,3,1,7,0,0,0,1,0.815833,0.750629,0.51875,0.168529,1421,4110,5531,3,1,7,0,0,0,1,0.8158333333333333,0.7506291666666667,0.5187499999999999,0.16852916666666665,1421,4110,5531,Weekend
549,2012-07-02,3,1,7,0,1,1,1,0.781667,0.702038,0.447083,0.195267,904,5323,6227,3,1,7,0,1,1,2,0.7816666666666666,0.7020375,0.44708333333333333,0.19526666666666667,904,5323,6227,Working Day
550,2012-07-03,3,1,7,0,2,1,1,0.780833,0.70265,0.492083,0.126237,1052,5608,6660,3,1,7,0,2,1,1,0.7808333333333333,0.7026499999999999,0.4920833333333334,0.1262375,1052,5608,6660,Working Day
551,2012-07-04,3,1,7,1,3,0,1,0.789167,0.732337,0.53875,0.13495,2562,4841,7403,3,1,7,1,3,0,1,0.7891666666666667,0.7323375,0.53875,0.13495,2562,4841,7403,Holiday
552,2012-07-05,3,1,7,0,4,1,1,0.8275,0.761367,0.457917,0.194029,1405,4836,6241,3,1,7,0,4,1,1,0.8275,0.7613666666666666,0.4579166666666667,0.19402916666666667,1405,4836,6241,Working Day
553,2012-07-06,3,1,7,0,5,1,1,0.828333,0.752533,0.450833,0.146142,1366,4841,6207,3,1,7,0,5,1,1,0.8283333333333333,0.7525333333333334,0.45083333333333336,0.14614166666666667,1366,4841,6207,Working Day
554,2012-07-07,3,1,7,0,6,0,1,0.861667,0.804913,0.492083,0.163554,1448,3392,4840,3,1,7,0,6,0,1,0.8616666666666667,0.8049125,0.4920833333333334,0.16355416666666667,1448,3392,4840,Weekend
555,2012-07-08,3,1,7,0,0,0,1,0.8225,0.790396,0.57375,0.125629,1203,3469,4672,3,1,7,0,0,0,1,0.8225000000000001,0.7903958333333333,0.57375,0.12562916666666665,1203,3469,4672,Weekend
556,2012-07-09,3,1,7,0,1,1,2,0.710833,0.654054,0.683333,0.180975,998,5571,6569,3,1,7,0,1,1,2,0.7108333333333333,0.6540541666666666,0.6833333333333332,0.180975,998,5571,6569,Working Day
557,2012-07-10,3,1,7,0,2,1,2,0.720833,0.664796,0.6675,0.151737,954,5336,6290,3,1,7,0,2,1,1,0.7208333333333333,0.6647958333333334,0.6675,0.1517375,954,5336,6290,Working Day
558,2012-07-11,3,1,7,0,3,1,1,0.716667,0.650271,0.633333,0.151733,975,6289,7264,3,1,7,0,3,1,2,0.7166666666666667,0.6502708333333332,0.6333333333333333,0.15173333333333333,975,6289,7264,Working Day
559,2012-07-12,3,1,7,0,4,1,1,0.715833,0.654683,0.529583,0.146775,1032,6414,7446,3,1,7,0,4,1,2,0.7158333333333333,0.6546833333333333,0.5295833333333333,0.14677500000000002,1032,6414,7446,Working Day
560,2012-07-13,3,1,7,0,5,1,2,0.731667,0.667933,0.485833,0.08085,1511,5988,7499,3,1,7,0,5,1,2,0.7316666666666666,0.6679333333333334,0.48583333333333334,0.08084999999999999,1511,5988,7499,Working Day
561,2012-07-14,3,1,7,0,6,0,2,0.703333,0.666042,0.699167,0.143679,2355,4614,6969,3,1,7,0,6,0,2,0.7033333333333333,0.6660416666666666,0.6991666666666667,0.14367916666666666,2355,4614,6969,Weekend
562,2012-07-15,3,1,7,0,0,0,1,0.745833,0.705196,0.717917,0.166667,1920,4111,6031,3,1,7,0,0,0,1,0.7458333333333332,0.7051958333333334,0.7179166666666666,0.16666666666666666,1920,4111,6031,Weekend
563,2012-07-16,3,1,7,0,1,1,1,0.763333,0.724125,0.645,0.164187,1088,5742,6830,3,1,7,0,1,1,3,0.7633333333333333,0.724125,0.645,0.1641875,1088,5742,6830,Working Day
564,2012-07-17,3,1,7,0,2,1,1,0.818333,0.755683,0.505833,0.114429,921,5865,6786,3,1,7,0,2,1,1,0.8183333333333334,0.7556833333333334,0.5058333333333334,0.11442916666666668,921,5865,6786,Working Day
565,2012-07-18,3,1,7,0,3,1,1,0.793333,0.745583,0.577083,0.137442,799,4914,5713,3,1,7,0,3,1,1,0.7933333333333333,0.7455833333333333,0.5770833333333333,0.13744166666666666,799,4914,5713,Working Day
566,2012-07-19,3,1,7,0,4,1,1,0.77,0.714642,0.600417,0.165429,888,5703,6591,3,1,7,0,4,1,1,0.77,0.7146416666666666,0.6004166666666667,0.16542916666666665,888,5703,6591,Working Day
567,2012-07-20,3,1,7,0,5,1,2,0.665833,0.613025,0.844167,0.208967,747,5123,5870,3,1,7,0,5,1,3,0.6658333333333334,0.613025,0.8441666666666666,0.20896666666666666,747,5123,5870,Working Day
568,2012-07-21,3,1,7,0,6,0,3,0.595833,0.549912,0.865417,0.2133,1264,3195,4459,3,1,7,0,6,0,3,0.5958333333333333,0.5499124999999999,0.8654166666666666,0.21330000000000002,1264,3195,4459,Weekend
569,2012-07-22,3,1,7,0,0,0,2,0.6675,0.623125,0.7625,0.0939208,2544,4866,7410,3,1,7,0,0,0,2,0.6675,0.623125,0.7625000000000001,0.09392083333333334,2544,4866,7410,Weekend
570,2012-07-23,3,1,7,0,1,1,1,0.741667,0.690017,0.694167,0.138683,1135,5831,6966,3,1,7,0,1,1,1,0.7416666666666667,0.6900166666666666,0.6941666666666667,0.13868333333333335,1135,5831,6966,Working Day
571,2012-07-24,3,1,7,0,2,1,1,0.750833,0.70645,0.655,0.211454,1140,6452,7592,3,1,7,0,2,1,1,0.7508333333333334,0.7064499999999999,0.655,0.2114541666666667,1140,6452,7592,Working Day
572,2012-07-25,3,1,7,0,3,1,1,0.724167,0.654054,0.45,0.1648,1383,6790,8173,3,1,7,0,3,1,1,0.7241666666666666,0.6540541666666666,0.45,0.1648,1383,6790,8173,Working Day
573,2012-07-26,3,1,7,0,4,1,1,0.776667,0.739263,0.596667,0.284813,1036,5825,6861,3,1,7,0,4,1,1,0.7766666666666667,0.7392625,0.5966666666666667,0.28481249999999997,1036,5825,6861,Working Day
574,2012-07-27,3,1,7,0,5,1,1,0.781667,0.734217,0.594583,0.152992,1259,5645,6904,3,1,7,0,5,1,1,0.7816666666666666,0.7342166666666667,0.5945833333333334,0.15299166666666666,1259,5645,6904,Working Day
575,2012-07-28,3,1,7,0,6,0,1,0.755833,0.697604,0.613333,0.15735,2234,4451,6685,3,1,7,0,6,0,1,0.7558333333333334,0.6976041666666667,0.6133333333333333,0.15735000000000002,2234,4451,6685,Weekend
576,2012-07-29,3,1,7,0,0,0,1,0.721667,0.667933,0.62375,0.170396,2153,4444,6597,3,1,7,0,0,0,1,0.7216666666666667,0.6679333333333334,0.62375,0.17039583333333333,2153,4444,6597,Weekend
577,2012-07-30,3,1,7,0,1,1,1,0.730833,0.684987,0.66875,0.153617,1040,6065,7105,3,1,7,0,1,1,1,0.7308333333333333,0.6849875,0.6687500000000001,0.15361666666666665,1040,6065,7105,Working Day
578,2012-07-31,3,1,7,0,2,1,1,0.713333,0.662896,0.704167,0.165425,968,6248,7216,3,1,7,0,2,1,1,0.7133333333333334,0.6628958333333334,0.7041666666666666,0.16542500000000002,968,6248,7216,Working Day
579,2012-08-01,3,1,8,0,3,1,1,0.7175,0.667308,0.6775,0.141179,1074,6506,7580,3,1,8,0,3,1,1,0.7174999999999999,0.6673083333333333,0.6775000000000001,0.14117916666666666,1074,6506,7580,Working Day
580,2012-08-02,3,1,8,0,4,1,1,0.7525,0.707088,0.659583,0.129354,983,6278,7261,3,1,8,0,4,1,1,0.7525,0.7070875,0.6595833333333333,0.12935416666666666,983,6278,7261,Working Day
581,2012-08-03,3,1,8,0,5,1,2,0.765833,0.722867,0.6425,0.215792,1328,5847,7175,3,1,8,0,5,1,1,0.7658333333333333,0.7228666666666667,0.6425,0.2157916666666667,1328,5847,7175,Working Day
582,2012-08-04,3,1,8,0,6,0,1,0.793333,0.751267,0.613333,0.257458,2345,4479,6824,3,1,8,0,6,0,1,0.7933333333333333,0.7512666666666666,0.6133333333333334,0.25745833333333334,2345,4479,6824,Weekend
583,2012-08-05,3,1,8,0,0,0,1,0.769167,0.731079,0.6525,0.290421,1707,3757,5464,3,1,8,0,0,0,1,0.7691666666666667,0.7310791666666666,0.6525,0.2904208333333333,1707,3757,5464,Weekend
584,2012-08-06,3,1,8,0,1,1,2,0.7525,0.710246,0.654167,0.129354,1233,5780,7013,3,1,8,0,1,1,2,0.7525,0.7102458333333334,0.6541666666666667,0.12935416666666666,1233,5780,7013,Working Day
585,2012-08-07,3,1,8,0,2,1,2,0.735833,0.697621,0.70375,0.116908,1278,5995,7273,3,1,8,0,2,1,1,0.7358333333333333,0.6976208333333332,0.70375,0.11690833333333334,1278,5995,7273,Working Day
586,2012-08-08,3,1,8,0,3,1,2,0.75,0.707717,0.672917,0.1107,1263,6271,7534,3,1,8,0,3,1,1,0.75,0.7077166666666667,0.6729166666666666,0.1107,1263,6271,7534,Working Day
587,2012-08-09,3,1,8,0,4,1,1,0.755833,0.699508,0.620417,0.1561,1196,6090,7286,3,1,8,0,4,1,1,0.7558333333333334,0.6995083333333333,0.6204166666666667,0.1561,1196,6090,7286,Working Day
588,2012-08-10,3,1,8,0,5,1,2,0.715833,0.667942,0.715833,0.238813,1065,4721,5786,3,1,8,0,5,1,1,0.7158333333333333,0.6679416666666667,0.7158333333333333,0.2388125,1065,4721,5786,Working Day
589,2012-08-11,3,1,8,0,6,0,2,0.6925,0.638267,0.732917,0.206479,2247,4052,6299,3,1,8,0,6,0,1,0.6925,0.6382666666666666,0.7329166666666667,0.20647916666666666,2247,4052,6299,Weekend
590,2012-08-12,3,1,8,0,0,0,1,0.700833,0.644579,0.530417,0.122512,2182,4362,6544,3,1,8,0,0,0,2,0.7008333333333333,0.6445791666666666,0.5304166666666666,0.12251250000000001,2182,4362,6544,Weekend
591,2012-08-13,3,1,8,0,1,1,1,0.720833,0.662254,0.545417,0.136212,1207,5676,6883,3,1,8,0,1,1,1,0.7208333333333333,0.6622541666666667,0.5454166666666667,0.1362125,1207,5676,6883,Working Day
592,2012-08-14,3,1,8,0,2,1,1,0.726667,0.676779,0.686667,0.169158,1128,5656,6784,3,1,8,0,2,1,1,0.7266666666666667,0.6767791666666666,0.6866666666666666,0.16915833333333333,1128,5656,6784,Working Day
593,2012-08-15,3,1,8,0,3,1,1,0.706667,0.654037,0.619583,0.169771,1198,6149,7347,3,1,8,0,3,1,1,0.7066666666666667,0.6540374999999999,0.6195833333333333,0.16977083333333334,1198,6149,7347,Working Day
594,2012-08-16,3,1,8,0,4,1,1,0.719167,0.654688,0.519167,0.141796,1338,6267,7605,3,1,8,0,4,1,1,0.7191666666666667,0.6546875,0.5191666666666667,0.14179583333333332,1338,6267,7605,Working Day
595,2012-08-17,3,1,8,0,5,1,1,0.723333,0.2424,0.570833,0.231354,1483,5665,7148,3,1,8,0,5,1,1,0.7233333333333333,0.24240000000000003,0.5708333333333333,0.23135416666666667,1483,5665,7148,Working Day
596,2012-08-18,3,1,8,0,6,0,1,0.678333,0.618071,0.603333,0.177867,2827,5038,7865,3,1,8,0,6,0,2,0.6783333333333333,0.6180708333333332,0.6033333333333334,0.17786666666666665,2827,5038,7865,Weekend
597,2012-08-19,3,1,8,0,0,0,2,0.635833,0.603554,0.711667,0.08645,1208,3341,4549,3,1,8,0,0,0,1,0.6358333333333334,0.6035541666666666,0.7116666666666666,0.08645000000000001,1208,3341,4549,Weekend
598,2012-08-20,3,1,8,0,1,1,2,0.635833,0.595967,0.734167,0.129979,1026,5504,6530,3,1,8,0,1,1,2,0.6358333333333334,0.5959666666666666,0.7341666666666667,0.12997916666666667,1026,5504,6530,Working Day
599,2012-08-21,3,1,8,0,2,1,1,0.649167,0.601025,0.67375,0.0727708,1081,5925,7006,3,1,8,0,2,1,2,0.6491666666666667,0.601025,0.67375,0.07277083333333334,1081,5925,7006,Working Day
600,2012-08-22,3,1,8,0,3,1,1,0.6675,0.621854,0.677083,0.0702833,1094,6281,7375,3,1,8,0,3,1,1,0.6675,0.6218541666666667,0.6770833333333334,0.07028333333333332,1094,6281,7375,Working Day
601,2012-08-23,3,1,8,0,4,1,1,0.695833,0.637008,0.635833,0.0845958,1363,6402,7765,3,1,8,0,4,1,1,0.6958333333333333,0.6370083333333333,0.6358333333333334,0.08459583333333333,1363,6402,7765,Working Day
602,2012-08-24,3,1,8,0,5,1,2,0.7025,0.6471,0.615,0.0721458,1325,6257,7582,3,1,8,0,5,1,2,0.7025,0.6470999999999999,0.615,0.07214583333333334,1325,6257,7582,Working Day
603,2012-08-25,3,1,8,0,6,0,2,0.661667,0.618696,0.712917,0.244408,1829,4224,6053,3,1,8,0,6,0,2,0.6616666666666667,0.6186958333333333,0.7129166666666666,0.24440833333333334,1829,4224,6053,Weekend
604,2012-08-26,3,1,8,0,0,0,2,0.653333,0.595996,0.845833,0.228858,1483,3772,5255,3,1,8,0,0,0,1,0.6533333333333333,0.5959958333333333,0.8458333333333333,0.22885833333333336,1483,3772,5255,Weekend
605,2012-08-27,3,1,8,0,1,1,1,0.703333,0.654688,0.730417,0.128733,989,5928,6917,3,1,8,0,1,1,1,0.7033333333333333,0.6546875,0.7304166666666667,0.12873333333333334,989,5928,6917,Working Day
606,2012-08-28,3,1,8,0,2,1,1,0.728333,0.66605,0.62,0.190925,935,6105,7040,3,1,8,0,2,1,1,0.7283333333333334,0.6660499999999999,0.62,0.190925,935,6105,7040,Working Day
607,2012-08-29,3,1,8,0,3,1,1,0.685,0.635733,0.552083,0.112562,1177,6520,7697,3,1,8,0,3,1,1,0.685,0.6357333333333334,0.5520833333333334,0.11256250000000001,1177,6520,7697,Working Day
608,2012-08-30,3,1,8,0,4,1,1,0.706667,0.652779,0.590417,0.0771167,1172,6541,7713,3,1,8,0,4,1,1,0.7066666666666667,0.6527791666666666,0.5904166666666667,0.07711666666666667,1172,6541,7713,Working Day
609,2012-08-31,3,1,8,0,5,1,1,0.764167,0.6894,0.5875,0.168533,1433,5917,7350,3,1,8,0,5,1,1,0.7641666666666667,0.6894,0.5875,0.16853333333333334,1433,5917,7350,Working Day
610,2012-09-01,3,1,9,0,6,0,2,0.753333,0.702654,0.638333,0.113187,2352,3788,6140,3,1,9,0,6,0,1,0.7533333333333333,0.7026541666666667,0.6383333333333333,0.1131875,2352,3788,6140,Weekend
611,2012-09-02,3,1,9,0,0,0,2,0.696667,0.649,0.815,0.0640708,2613,3197,5810,3,1,9,0,0,0,2,0.6966666666666667,0.6489999999999999,0.815,0.06407083333333334,2613,3197,5810,Weekend
612,2012-09-03,3,1,9,1,1,0,1,0.7075,0.661629,0.790833,0.151121,1965,4069,6034,3,1,9,1,1,0,2,0.7075,0.6616291666666666,0.7908333333333334,0.15112083333333334,1965,4069,6034,Holiday
613,2012-09-04,3,1,9,0,2,1,1,0.725833,0.686888,0.755,0.236321,867,5997,6864,3,1,9,0,2,1,2,0.7258333333333334,0.6868875,0.755,0.2363208333333333,867,5997,6864,Working Day
614,2012-09-05,3,1,9,0,3,1,1,0.736667,0.708983,0.74125,0.187808,832,6280,7112,3,1,9,0,3,1,1,0.7366666666666667,0.7089833333333333,0.74125,0.18780833333333333,832,6280,7112,Working Day
615,2012-09-06,3,1,9,0,4,1,2,0.696667,0.655329,0.810417,0.142421,611,5592,6203,3,1,9,0,4,1,2,0.6966666666666667,0.6553291666666666,0.8104166666666667,0.14242083333333333,611,5592,6203,Working Day
616,2012-09-07,3,1,9,0,5,1,1,0.703333,0.657204,0.73625,0.171646,1045,6459,7504,3,1,9,0,5,1,1,0.7033333333333333,0.6572041666666667,0.7362500000000001,0.17164583333333336,1045,6459,7504,Working Day
617,2012-09-08,3,1,9,0,6,0,2,0.659167,0.611121,0.799167,0.281104,1557,4419,5976,3,1,9,0,6,0,1,0.6591666666666667,0.6111208333333333,0.7991666666666667,0.28110416666666665,1557,4419,5976,Weekend
618,2012-09-09,3,1,9,0,0,0,1,0.61,0.578925,0.5475,0.224496,2570,5657,8227,3,1,9,0,0,0,2,0.61,0.578925,0.5475,0.22449583333333334,2570,5657,8227,Weekend
619,2012-09-10,3,1,9,0,1,1,1,0.583333,0.565654,0.50375,0.258713,1118,6407,7525,3,1,9,0,1,1,1,0.5833333333333334,0.5656541666666667,0.50375,0.2587125,1118,6407,7525,Working Day
620,2012-09-11,3,1,9,0,2,1,1,0.5775,0.554292,0.52,0.0920542,1070,6697,7767,3,1,9,0,2,1,1,0.5775,0.5542916666666666,0.52,0.09205416666666666,1070,6697,7767,Working Day
621,2012-09-12,3,1,9,0,3,1,1,0.599167,0.570075,0.577083,0.131846,1050,6820,7870,3,1,9,0,3,1,1,0.5991666666666667,0.570075,0.5770833333333333,0.13184583333333333,1050,6820,7870,Working Day
622,2012-09-13,3,1,9,0,4,1,1,0.6125,0.579558,0.637083,0.0827208,1054,6750,7804,3,1,9,0,4,1,1,0.6124999999999999,0.5795583333333333,0.6370833333333333,0.08272083333333334,1054,6750,7804,Working Day
623,2012-09-14,3,1,9,0,5,1,1,0.633333,0.594083,0.6725,0.103863,1379,6630,8009,3,1,9,0,5,1,1,0.6333333333333334,0.5940833333333333,0.6725,0.10386250000000001,1379,6630,8009,Working Day
624,2012-09-15,3,1,9,0,6,0,1,0.608333,0.585867,0.501667,0.247521,3160,5554,8714,3,1,9,0,6,0,1,0.6083333333333333,0.5858666666666666,0.5016666666666666,0.24752083333333333,3160,5554,8714,Weekend
625,2012-09-16,3,1,9,0,0,0,1,0.58,0.563125,0.57,0.0901833,2166,5167,7333,3,1,9,0,0,0,1,0.58,0.563125,0.57,0.09018333333333334,2166,5167,7333,Weekend
626,2012-09-17,3,1,9,0,1,1,2,0.580833,0.55305,0.734583,0.151742,1022,5847,6869,3,1,9,0,1,1,1,0.5808333333333333,0.5530499999999999,0.7345833333333333,0.15174166666666666,1022,5847,6869,Working Day
627,2012-09-18,3,1,9,0,2,1,2,0.623333,0.565067,0.8725,0.357587,371,3702,4073,3,1,9,0,2,1,3,0.6233333333333334,0.5650666666666667,0.8725,0.3575875,371,3702,4073,Working Day
628,2012-09-19,3,1,9,0,3,1,1,0.5525,0.540404,0.536667,0.215175,788,6803,7591,3,1,9,0,3,1,2,0.5525,0.5404041666666667,0.5366666666666667,0.215175,788,6803,7591,Working Day
629,2012-09-20,3,1,9,0,4,1,1,0.546667,0.532192,0.618333,0.118167,939,6781,7720,3,1,9,0,4,1,1,0.5466666666666667,0.5321916666666667,0.6183333333333333,0.11816666666666666,939,6781,7720,Working Day
630,2012-09-21,3,1,9,0,5,1,1,0.599167,0.571971,0.66875,0.154229,1250,6917,8167,3,1,9,0,5,1,1,0.5991666666666667,0.5719708333333333,0.6687500000000001,0.15422916666666667,1250,6917,8167,Working Day
631,2012-09-22,3,1,9,0,6,0,1,0.65,0.610488,0.646667,0.283583,2512,5883,8395,3,1,9,0,6,0,1,0.65,0.6104875,0.6466666666666666,0.28358333333333335,2512,5883,8395,Weekend
632,2012-09-23,4,1,9,0,0,0,1,0.529167,0.518933,0.467083,0.223258,2454,5453,7907,4,1,9,0,0,0,1,0.5291666666666667,0.5189333333333334,0.46708333333333335,0.22325833333333334,2454,5453,7907,Weekend
633,2012-09-24,4,1,9,0,1,1,1,0.514167,0.502513,0.492917,0.142404,1001,6435,7436,4,1,9,0,1,1,1,0.5141666666666667,0.5025125,0.49291666666666667,0.14240416666666667,1001,6435,7436,Working Day
634,2012-09-25,4,1,9,0,2,1,1,0.55,0.544179,0.57,0.236321,845,6693,7538,4,1,9,0,2,1,1,0.5499999999999999,0.5441791666666667,0.57,0.23632083333333334,845,6693,7538,Working Day
635,2012-09-26,4,1,9,0,3,1,1,0.635,0.596613,0.630833,0.2444,787,6946,7733,4,1,9,0,3,1,1,0.635,0.5966125,0.6308333333333334,0.24439999999999998,787,6946,7733,Working Day
636,2012-09-27,4,1,9,0,4,1,2,0.65,0.607975,0.690833,0.134342,751,6642,7393,4,1,9,0,4,1,1,0.65,0.607975,0.6908333333333333,0.13434166666666666,751,6642,7393,Working Day
637,2012-09-28,4,1,9,0,5,1,2,0.619167,0.585863,0.69,0.164179,1045,6370,7415,4,1,9,0,5,1,3,0.6191666666666666,0.5858625,0.69,0.16417916666666665,1045,6370,7415,Working Day
638,2012-09-29,4,1,9,0,6,0,1,0.5425,0.530296,0.542917,0.227604,2589,5966,8555,4,1,9,0,6,0,1,0.5425,0.5302958333333333,0.5429166666666667,0.2276041666666667,2589,5966,8555,Weekend
639,2012-09-30,4,1,9,0,0,0,1,0.526667,0.517663,0.583333,0.134958,2015,4874,6889,4,1,9,0,0,0,1,0.5266666666666667,0.5176625,0.5833333333333334,0.13495833333333332,2015,4874,6889,Weekend
640,2012-10-01,4,1,10,0,1,1,2,0.520833,0.512,0.649167,0.0908042,763,6015,6778,4,1,10,0,1,1,1,0.5208333333333334,0.512,0.6491666666666667,0.09080416666666667,763,6015,6778,Working Day
641,2012-10-02,4,1,10,0,2,1,3,0.590833,0.542333,0.871667,0.104475,315,4324,4639,4,1,10,0,2,1,2,0.5908333333333333,0.5423333333333333,0.8716666666666666,0.104475,315,4324,4639,Working Day
642,2012-10-03,4,1,10,0,3,1,2,0.6575,0.599133,0.79375,0.0665458,728,6844,7572,4,1,10,0,3,1,3,0.6575,0.5991333333333333,0.7937500000000001,0.06654583333333333,728,6844,7572,Working Day
643,2012-10-04,4,1,10,0,4,1,2,0.6575,0.607975,0.722917,0.117546,891,6437,7328,4,1,10,0,4,1,3,0.6575,0.607975,0.7229166666666668,0.11754583333333334,891,6437,7328,Working Day
644,2012-10-05,4,1,10,0,5,1,1,0.615,0.580187,0.6275,0.10635,1516,6640,8156,4,1,10,0,5,1,1,0.615,0.5801875,0.6275000000000001,0.10635,1516,6640,8156,Working Day
645,2012-10-06,4,1,10,0,6,0,1,0.554167,0.538521,0.664167,0.268025,3031,4934,7965,4,1,10,0,6,0,1,0.5541666666666667,0.5385208333333333,0.6641666666666667,0.268025,3031,4934,7965,Weekend
646,2012-10-07,4,1,10,0,0,0,2,0.415833,0.419813,0.708333,0.141162,781,2729,3510,4,1,10,0,0,0,1,0.41583333333333333,0.4198125,0.7083333333333334,0.1411625,781,2729,3510,Weekend
647,2012-10-08,4,1,10,1,1,0,2,0.383333,0.387608,0.709583,0.189679,874,4604,5478,4,1,10,1,1,0,1,0.3833333333333333,0.38760833333333333,0.7095833333333333,0.18967916666666665,874,4604,5478,Holiday
648,2012-10-09,4,1,10,0,2,1,2,0.446667,0.438112,0.761667,0.1903,601,5791,6392,4,1,10,0,2,1,2,0.4466666666666667,0.43811249999999996,0.7616666666666667,0.1903,601,5791,6392,Working Day
649,2012-10-10,4,1,10,0,3,1,1,0.514167,0.503142,0.630833,0.187821,780,6911,7691,4,1,10,0,3,1,2,0.5141666666666667,0.5031416666666667,0.6308333333333334,0.18782083333333333,780,6911,7691,Working Day
650,2012-10-11,4,1,10,0,4,1,1,0.435,0.431167,0.463333,0.181596,834,6736,7570,4,1,10,0,4,1,1,0.435,0.4311666666666667,0.4633333333333333,0.18159583333333332,834,6736,7570,Working Day
651,2012-10-12,4,1,10,0,5,1,1,0.4375,0.433071,0.539167,0.235092,1060,6222,7282,4,1,10,0,5,1,1,0.4375,0.43307083333333335,0.5391666666666667,0.23509166666666667,1060,6222,7282,Working Day
652,2012-10-13,4,1,10,0,6,0,1,0.393333,0.391396,0.494583,0.146142,2252,4857,7109,4,1,10,0,6,0,1,0.3933333333333333,0.39139583333333333,0.4945833333333333,0.14614166666666667,2252,4857,7109,Weekend
653,2012-10-14,4,1,10,0,0,0,1,0.521667,0.508204,0.640417,0.278612,2080,4559,6639,4,1,10,0,0,0,1,0.5216666666666666,0.5082041666666667,0.6404166666666666,0.2786125,2080,4559,6639,Weekend
654,2012-10-15,4,1,10,0,1,1,2,0.561667,0.53915,0.7075,0.296037,760,5115,5875,4,1,10,0,1,1,2,0.5616666666666666,0.53915,0.7075,0.2960375,760,5115,5875,Working Day
655,2012-10-16,4,1,10,0,2,1,1,0.468333,0.460846,0.558333,0.182221,922,6612,7534,4,1,10,0,2,1,1,0.4683333333333333,0.46084583333333334,0.5583333333333333,0.18222083333333336,922,6612,7534,Working Day
656,2012-10-17,4,1,10,0,3,1,1,0.455833,0.450108,0.692917,0.101371,979,6482,7461,4,1,10,0,3,1,1,0.4558333333333333,0.45010833333333333,0.6929166666666666,0.10137083333333334,979,6482,7461,Working Day
657,2012-10-18,4,1,10,0,4,1,2,0.5225,0.512625,0.728333,0.236937,1008,6501,7509,4,1,10,0,4,1,1,0.5225000000000001,0.512625,0.7283333333333334,0.2369375,1008,6501,7509,Working Day
658,2012-10-19,4,1,10,0,5,1,2,0.563333,0.537896,0.815,0.134954,753,4671,5424,4,1,10,0,5,1,2,0.5633333333333334,0.5378958333333334,0.815,0.13495416666666668,753,4671,5424,Working Day
659,2012-10-20,4,1,10,0,6,0,1,0.484167,0.472842,0.572917,0.117537,2806,5284,8090,4,1,10,0,6,0,1,0.4841666666666667,0.47284166666666666,0.5729166666666666,0.1175375,2806,5284,8090,Weekend
660,2012-10-21,4,1,10,0,0,0,1,0.464167,0.456429,0.51,0.166054,2132,4692,6824,4,1,10,0,0,0,1,0.46416666666666667,0.45642916666666666,0.51,0.16605416666666667,2132,4692,6824,Weekend
661,2012-10-22,4,1,10,0,1,1,1,0.4875,0.482942,0.568333,0.0814833,830,6228,7058,4,1,10,0,1,1,1,0.4875,0.48294166666666666,0.5683333333333334,0.08148333333333334,830,6228,7058,Working Day
662,2012-10-23,4,1,10,0,2,1,1,0.544167,0.530304,0.641667,0.0945458,841,6625,7466,4,1,10,0,2,1,1,0.5441666666666667,0.5303041666666667,0.6416666666666667,0.09454583333333333,841,6625,7466,Working Day
663,2012-10-24,4,1,10,0,3,1,1,0.5875,0.558721,0.63625,0.0727792,795,6898,7693,4,1,10,0,3,1,1,0.5875,0.5587208333333333,0.63625,0.07277916666666666,795,6898,7693,Working Day
664,2012-10-25,4,1,10,0,4,1,2,0.55,0.529688,0.800417,0.124375,875,6484,7359,4,1,10,0,4,1,2,0.55,0.5296875,0.8004166666666667,0.124375,875,6484,7359,Working Day
665,2012-10-26,4,1,10,0,5,1,2,0.545833,0.52275,0.807083,0.132467,1182,6262,7444,4,1,10,0,5,1,2,0.5458333333333333,0.5227499999999999,0.8070833333333334,0.13246666666666668,1182,6262,7444,Working Day
666,2012-10-27,4,1,10,0,6,0,2,0.53,0.515133,0.72,0.235692,2643,5209,7852,4,1,10,0,6,0,1,0.53,0.5151333333333333,0.7200000000000001,0.23569166666666666,2643,5209,7852,Weekend
667,2012-10-28,4,1,10,0,0,0,2,0.4775,0.467771,0.694583,0.398008,998,3461,4459,4,1,10,0,0,0,3,0.4775,0.4677708333333333,0.6945833333333332,0.39800833333333335,998,3461,4459,Weekend
668,2012-10-29,4,1,10,0,1,1,3,0.44,0.4394,0.88,0.3582,2,20,22,4,1,10,0,1,1,3,0.44,0.4394,0.88,0.3582,2,20,22,Working Day
669,2012-10-30,4,1,10,0,2,1,2,0.318182,0.309909,0.825455,0.213009,87,1009,1096,4,1,10,0,2,1,3,0.3181818181818182,0.3099090909090909,0.8254545454545454,0.21300909090909093,87,1009,1096,Working Day
670,2012-10-31,4,1,10,0,3,1,2,0.3575,0.3611,0.666667,0.166667,419,5147,5566,4,1,10,0,3,1,2,0.3575,0.3611,0.6666666666666666,0.16666666666666666,419,5147,5566,Working Day
671,2012-11-01,4,1,11,0,4,1,2,0.365833,0.369942,0.581667,0.157346,466,5520,5986,4,1,11,0,4,1,1,0.3658333333333333,0.36994166666666667,0.5816666666666667,0.15734583333333332,466,5520,5986,Working Day
672,2012-11-02,4,1,11,0,5,1,1,0.355,0.356042,0.522083,0.266175,618,5229,5847,4,1,11,0,5,1,1,0.355,0.35604166666666665,0.5220833333333333,0.266175,618,5229,5847,Working Day
673,2012-11-03,4,1,11,0,6,0,2,0.343333,0.323846,0.49125,0.270529,1029,4109,5138,4,1,11,0,6,0,1,0.3433333333333333,0.32384583333333333,0.49124999999999996,0.27052916666666665,1029,4109,5138,Weekend
674,2012-11-04,4,1,11,0,0,0,1,0.325833,0.329538,0.532917,0.179108,1201,3906,5107,4,1,11,0,0,0,1,0.32583333333333336,0.3295375,0.5329166666666667,0.17910833333333334,1201,3906,5107,Weekend
675,2012-11-05,4,1,11,0,1,1,1,0.319167,0.308075,0.494167,0.236325,378,4881,5259,4,1,11,0,1,1,2,0.31916666666666665,0.308075,0.4941666666666667,0.236325,378,4881,5259,Working Day
676,2012-11-06,4,1,11,0,2,1,1,0.280833,0.281567,0.567083,0.173513,466,5220,5686,4,1,11,0,2,1,1,0.2808333333333333,0.2815666666666667,0.5670833333333333,0.1735125,466,5220,5686,Working Day
677,2012-11-07,4,1,11,0,3,1,2,0.295833,0.274621,0.5475,0.304108,326,4709,5035,4,1,11,0,3,1,2,0.29583333333333334,0.2746208333333333,0.5475,0.30410833333333337,326,4709,5035,Working Day
678,2012-11-08,4,1,11,0,4,1,1,0.352174,0.341891,0.333478,0.347835,340,4975,5315,4,1,11,0,4,1,3,0.3521739130434782,0.3418913043478261,0.3334782608695652,0.34783478260869566,340,4975,5315,Working Day
679,2012-11-09,4,1,11,0,5,1,1,0.361667,0.355413,0.540833,0.214558,709,5283,5992,4,1,11,0,5,1,1,0.36166666666666664,0.35541249999999996,0.5408333333333334,0.21455833333333332,709,5283,5992,Working Day
680,2012-11-10,4,1,11,0,6,0,1,0.389167,0.393937,0.645417,0.0578458,2090,4446,6536,4,1,11,0,6,0,1,0.38916666666666666,0.3939375,0.6454166666666666,0.05784583333333334,2090,4446,6536,Weekend
681,2012-11-11,4,1,11,0,0,0,1,0.420833,0.421713,0.659167,0.1275,2290,4562,6852,4,1,11,0,0,0,1,0.42083333333333334,0.4217125,0.6591666666666667,0.1275,2290,4562,6852,Weekend
682,2012-11-12,4,1,11,1,1,0,1,0.485,0.475383,0.741667,0.173517,1097,5172,6269,4,1,11,1,1,0,1,0.48500000000000004,0.4753833333333333,0.7416666666666667,0.17351666666666665,1097,5172,6269,Holiday
683,2012-11-13,4,1,11,0,2,1,2,0.343333,0.323225,0.662917,0.342046,327,3767,4094,4,1,11,0,2,1,2,0.3433333333333333,0.323225,0.6629166666666667,0.3420458333333333,327,3767,4094,Working Day
684,2012-11-14,4,1,11,0,3,1,1,0.289167,0.281563,0.552083,0.199625,373,5122,5495,4,1,11,0,3,1,1,0.2891666666666667,0.2815625,0.5520833333333334,0.19962500000000002,373,5122,5495,Working Day
685,2012-11-15,4,1,11,0,4,1,2,0.321667,0.324492,0.620417,0.152987,320,5125,5445,4,1,11,0,4,1,2,0.32166666666666666,0.3244916666666667,0.6204166666666667,0.1529875,320,5125,5445,Working Day
686,2012-11-16,4,1,11,0,5,1,1,0.345,0.347204,0.524583,0.171025,484,5214,5698,4,1,11,0,5,1,2,0.345,0.3472041666666667,0.5245833333333333,0.17102499999999998,484,5214,5698,Working Day
687,2012-11-17,4,1,11,0,6,0,1,0.325,0.326383,0.545417,0.179729,1313,4316,5629,4,1,11,0,6,0,1,0.325,0.3263833333333333,0.5454166666666667,0.1797291666666667,1313,4316,5629,Weekend
688,2012-11-18,4,1,11,0,0,0,1,0.3425,0.337746,0.692917,0.227612,922,3747,4669,4,1,11,0,0,0,2,0.3425,0.33774583333333336,0.6929166666666666,0.2276125,922,3747,4669,Weekend
689,2012-11-19,4,1,11,0,1,1,2,0.380833,0.375621,0.623333,0.235067,449,5050,5499,4,1,11,0,1,1,1,0.38083333333333336,0.3756208333333333,0.6233333333333334,0.23506666666666665,449,5050,5499,Working Day
690,2012-11-20,4,1,11,0,2,1,2,0.374167,0.380667,0.685,0.082725,534,5100,5634,4,1,11,0,2,1,1,0.3741666666666667,0.38066666666666665,0.685,0.082725,534,5100,5634,Working Day
691,2012-11-21,4,1,11,0,3,1,1,0.353333,0.364892,0.61375,0.103246,615,4531,5146,4,1,11,0,3,1,1,0.35333333333333333,0.36489166666666667,0.61375,0.10324583333333333,615,4531,5146,Working Day
692,2012-11-22,4,1,11,1,4,0,1,0.34,0.350371,0.580417,0.0528708,955,1470,2425,4,1,11,1,4,0,1,0.34,0.3503708333333333,0.5804166666666667,0.05287083333333333,955,1470,2425,Holiday
693,2012-11-23,4,1,11,0,5,1,1,0.368333,0.378779,0.56875,0.148021,1603,2307,3910,4,1,11,0,5,1,1,0.36833333333333335,0.37877916666666667,0.56875,0.14802083333333335,1603,2307,3910,Working Day
694,2012-11-24,4,1,11,0,6,0,1,0.278333,0.248742,0.404583,0.376871,532,1745,2277,4,1,11,0,6,0,1,0.2783333333333333,0.24874166666666667,0.4045833333333333,0.3768708333333333,532,1745,2277,Weekend
695,2012-11-25,4,1,11,0,0,0,1,0.245833,0.257583,0.468333,0.1505,309,2115,2424,4,1,11,0,0,0,1,0.24583333333333335,0.25758333333333333,0.4683333333333333,0.1505,309,2115,2424,Weekend
696,2012-11-26,4,1,11,0,1,1,1,0.313333,0.339004,0.535417,0.04665,337,4750,5087,4,1,11,0,1,1,1,0.31333333333333335,0.3390041666666667,0.5354166666666667,0.04665,337,4750,5087,Working Day
697,2012-11-27,4,1,11,0,2,1,2,0.291667,0.281558,0.786667,0.237562,123,3836,3959,4,1,11,0,2,1,2,0.2916666666666667,0.2815583333333333,0.7866666666666666,0.2375625,123,3836,3959,Working Day
698,2012-11-28,4,1,11,0,3,1,1,0.296667,0.289762,0.50625,0.210821,198,5062,5260,4,1,11,0,3,1,2,0.2966666666666667,0.2897625,0.50625,0.21082083333333335,198,5062,5260,Working Day
699,2012-11-29,4,1,11,0,4,1,1,0.28087,0.298422,0.555652,0.115522,243,5080,5323,4,1,11,0,4,1,1,0.2808695652173913,0.2984217391304348,0.5556521739130434,0.11552173913043479,243,5080,5323,Working Day
700,2012-11-30,4,1,11,0,5,1,1,0.298333,0.323867,0.649583,0.0584708,362,5306,5668,4,1,11,0,5,1,1,0.29833333333333334,0.3238666666666667,0.6495833333333333,0.05847083333333333,362,5306,5668,Working Day
701,2012-12-01,4,1,12,0,6,0,2,0.298333,0.316904,0.806667,0.0597042,951,4240,5191,4,1,12,0,6,0,1,0.29833333333333334,0.31690416666666665,0.8066666666666666,0.05970416666666667,951,4240,5191,Weekend
702,2012-12-02,4,1,12,0,0,0,2,0.3475,0.359208,0.823333,0.124379,892,3757,4649,4,1,12,0,0,0,2,0.3475,0.35920833333333335,0.8233333333333334,0.12437916666666667,892,3757,4649,Weekend
703,2012-12-03,4,1,12,0,1,1,1,0.4525,0.455796,0.7675,0.0827208,555,5679,6234,4,1,12,0,1,1,2,0.45249999999999996,0.45579583333333334,0.7675000000000001,0.08272083333333334,555,5679,6234,Working Day
704,2012-12-04,4,1,12,0,2,1,1,0.475833,0.469054,0.73375,0.174129,551,6055,6606,4,1,12,0,2,1,1,0.47583333333333333,0.4690541666666667,0.73375,0.17412916666666667,551,6055,6606,Working Day
705,2012-12-05,4,1,12,0,3,1,1,0.438333,0.428012,0.485,0.324021,331,5398,5729,4,1,12,0,3,1,1,0.4383333333333333,0.42801249999999996,0.48500000000000004,0.32402083333333337,331,5398,5729,Working Day
706,2012-12-06,4,1,12,0,4,1,1,0.255833,0.258204,0.50875,0.174754,340,5035,5375,4,1,12,0,4,1,1,0.2558333333333333,0.2582041666666667,0.50875,0.17475416666666665,340,5035,5375,Working Day
707,2012-12-07,4,1,12,0,5,1,2,0.320833,0.321958,0.764167,0.1306,349,4659,5008,4,1,12,0,5,1,1,0.32083333333333336,0.3219583333333333,0.7641666666666667,0.1306,349,4659,5008,Working Day
708,2012-12-08,4,1,12,0,6,0,2,0.381667,0.389508,0.91125,0.101379,1153,4429,5582,4,1,12,0,6,0,2,0.38166666666666665,0.38950833333333335,0.91125,0.10137916666666667,1153,4429,5582,Weekend
709,2012-12-09,4,1,12,0,0,0,2,0.384167,0.390146,0.905417,0.157975,441,2787,3228,4,1,12,0,0,0,2,0.3841666666666667,0.39014583333333336,0.9054166666666666,0.157975,441,2787,3228,Weekend
710,2012-12-10,4,1,12,0,1,1,2,0.435833,0.435575,0.925,0.190308,329,4841,5170,4,1,12,0,1,1,3,0.43583333333333335,0.435575,0.9249999999999999,0.19030833333333333,329,4841,5170,Working Day
711,2012-12-11,4,1,12,0,2,1,2,0.353333,0.338363,0.596667,0.296037,282,5219,5501,4,1,12,0,2,1,3,0.35333333333333333,0.33836249999999995,0.5966666666666667,0.2960375,282,5219,5501,Working Day
712,2012-12-12,4,1,12,0,3,1,2,0.2975,0.297338,0.538333,0.162937,310,5009,5319,4,1,12,0,3,1,1,0.29750000000000004,0.2973375,0.5383333333333333,0.16293749999999999,310,5009,5319,Working Day
713,2012-12-13,4,1,12,0,4,1,1,0.295833,0.294188,0.485833,0.174129,425,5107,5532,4,1,12,0,4,1,2,0.29583333333333334,0.2941875,0.48583333333333334,0.17412916666666667,425,5107,5532,Working Day
714,2012-12-14,4,1,12,0,5,1,1,0.281667,0.294192,0.642917,0.131229,429,5182,5611,4,1,12,0,5,1,1,0.2816666666666667,0.2941916666666667,0.6429166666666667,0.13122916666666667,429,5182,5611,Working Day
715,2012-12-15,4,1,12,0,6,0,1,0.324167,0.338383,0.650417,0.10635,767,4280,5047,4,1,12,0,6,0,1,0.32416666666666666,0.3383833333333333,0.6504166666666666,0.10635,767,4280,5047,Weekend
716,2012-12-16,4,1,12,0,0,0,2,0.3625,0.369938,0.83875,0.100742,538,3248,3786,4,1,12,0,0,0,2,0.3625,0.3699375,0.83875,0.10074166666666667,538,3248,3786,Weekend
717,2012-12-17,4,1,12,0,1,1,2,0.393333,0.4015,0.907083,0.0982583,212,4373,4585,4,1,12,0,1,1,2,0.3933333333333333,0.40149999999999997,0.9070833333333334,0.09825833333333334,212,4373,4585,Working Day
718,2012-12-18,4,1,12,0,2,1,1,0.410833,0.409708,0.66625,0.221404,433,5124,5557,4,1,12,0,2,1,2,0.41083333333333333,0.40970833333333334,0.66625,0.22140416666666665,433,5124,5557,Working Day
719,2012-12-19,4,1,12,0,3,1,1,0.3325,0.342162,0.625417,0.184092,333,4934,5267,4,1,12,0,3,1,1,0.3325,0.3421625,0.6254166666666666,0.18409166666666665,333,4934,5267,Working Day
720,2012-12-20,4,1,12,0,4,1,2,0.33,0.335217,0.667917,0.132463,314,3814,4128,4,1,12,0,4,1,1,0.33,0.33521666666666666,0.6679166666666667,0.1324625,314,3814,4128,Working Day
721,2012-12-21,1,1,12,0,5,1,2,0.326667,0.301767,0.556667,0.374383,221,3402,3623,1,1,12,0,5,1,3,0.32666666666666666,0.3017666666666667,0.5566666666666666,0.37438333333333335,221,3402,3623,Working Day
722,2012-12-22,1,1,12,0,6,0,1,0.265833,0.236113,0.44125,0.407346,205,1544,1749,1,1,12,0,6,0,1,0.2658333333333333,0.23611250000000003,0.44125,0.4073458333333333,205,1544,1749,Weekend
723,2012-12-23,1,1,12,0,0,0,1,0.245833,0.259471,0.515417,0.133083,408,1379,1787,1,1,12,0,0,0,1,0.24583333333333335,0.2594708333333333,0.5154166666666666,0.13308333333333333,408,1379,1787,Weekend
724,2012-12-24,1,1,12,0,1,1,2,0.231304,0.2589,0.791304,0.0772304,174,746,920,1,1,12,0,1,1,1,0.23130434782608697,0.2589,0.7913043478260869,0.0772304347826087,174,746,920,Working Day
725,2012-12-25,1,1,12,1,2,0,2,0.291304,0.294465,0.734783,0.168726,440,573,1013,1,1,12,1,2,0,3,0.29130434782608694,0.2944652173913043,0.7347826086956522,0.16872608695652175,440,573,1013,Holiday
726,2012-12-26,1,1,12,0,3,1,3,0.243333,0.220333,0.823333,0.316546,9,432,441,1,1,12,0,3,1,2,0.24333333333333332,0.22033333333333335,0.8233333333333334,0.31654583333333336,9,432,441,Working Day
727,2012-12-27,1,1,12,0,4,1,2,0.254167,0.226642,0.652917,0.350133,247,1867,2114,1,1,12,0,4,1,3,0.25416666666666665,0.22664166666666666,0.6529166666666667,0.35013333333333335,247,1867,2114,Working Day
728,2012-12-28,1,1,12,0,5,1,2,0.253333,0.255046,0.59,0.155471,644,2451,3095,1,1,12,0,5,1,2,0.25333333333333335,0.25504583333333336,0.59,0.15547083333333334,644,2451,3095,Working Day
729,2012-12-29,1,1,12,0,6,0,2,0.253333,0.2424,0.752917,0.124383,159,1182,1341,1,1,12,0,6,0,2,0.25333333333333335,0.24240000000000003,0.7529166666666667,0.12438333333333333,159,1182,1341,Weekend
730,2012-12-30,1,1,12,0,0,0,1,0.255833,0.2317,0.483333,0.350754,364,1432,1796,1,1,12,0,0,0,2,0.25583333333333336,0.23170000000000002,0.48333333333333334,0.35075416666666664,364,1432,1796,Weekend
731,2012-12-31,1,1,12,0,1,1,2,0.215833,0.223487,0.5775,0.154846,439,2290,2729,1,1,12,0,1,1,1,0.21583333333333332,0.22348749999999998,0.5775,0.15484583333333332,439,2290,2729,Working Day
